Year,Patient County Code,Patient County Name,Rural/Urban,Payer,ER Opioid,ER Visits ,ER Rate Per 1000 ,Inpatient ER Opioid,Inpatient ER Discharges,Inpatient ER Rate Per 1000,Inpatient Non ER Opioid,Inpatient Non ER Discharges,Inpatient Non ER Rate Per 1000 ,Inpatient Total Opioid,Inpatient Total Discharges,Inpatient Total Rate Per 1000 ,ER Inpatient Total Opioid,ER Inpatient Total Discharges ,ER Inpatient Total Rate Per 1000,Opioid Ambulatory Surgery Visits,Ambulatory Surgery Visits,Ambulatory Surgery Rate Per 1000,Outpatient Opioid,Outpatient Visits,Outpatient Rate Per 1000,Other Outpatient Total Opioid, Other Outpatient Total Discharges,Other Outpatient Total Rate Per 1000,Overall Opioid,Overall Discharges,Overall Rate Per 1000
2013,1,Albany,Urban,Medicaid,22,35379,0.622,15,3408,4.401,1,3529,0.283,16,6937,2.306,38,42316,0.898,0,3945,0,0,29976,0,0,33921,0,38,76237,0.498
2010,1,Albany,Urban,Medicare,13,13486,0.964,13,10785,1.205,1,3370,0.297,14,14155,0.989,27,27641,0.977,0,9511,0,0,105,0,0,9616,0,27,37257,0.725
2010,2,Allegany,Rural,Medicaid,0,3917,0,2,422,4.739,1,710,1.408,3,1132,2.65,3,5049,0.594,0,816,0,0,26,0,0,842,0,3,5891,0.509
2013,2,Allegany,Rural,Medicaid,1,6273,0.159,1,292,3.425,0,474,0,1,766,1.305,2,7039,0.284,0,776,0,0,5612,0,0,6388,0,2,13427,0.149
2010,2,Allegany,Rural,Other,1,451,2.217,0,59,0,0,47,0,0,106,0,1,557,1.795,0,108,0,0,10,0,0,118,0,1,675,1.481
2012,2,Allegany,Rural,Other,0,560,0,0,62,0,0,51,0,0,113,0,0,673,0,0,79,0,0,1010,0,0,1089,0,0,1762,0
2010,3,Broome,Urban,Commercial,24,24971,0.961,13,2847,4.566,0,4269,0,13,7116,1.827,37,32087,1.153,0,9553,0,0,23,0,0,9576,0,37,41663,0.888
2010,3,Broome,Urban,Medicaid,14,18615,0.752,18,1793,10.039,3,2368,1.267,21,4161,5.047,35,22776,1.537,0,1572,0,0,16,0,0,1588,0,35,24364,1.437
2010,3,Broome,Urban,Medicare,6,12025,0.499,4,6800,0.588,0,2421,0,4,9221,0.434,10,21246,0.471,0,6225,0,0,20,0,0,6245,0,10,27491,0.364
2010,3,Broome,Urban,Other,0,1103,0,0,121,0,0,59,0,0,180,0,0,1283,0,0,161,0,0,1,0,0,162,0,0,1445,0
2011,3,Broome,Urban,Other,2,1769,1.131,1,191,5.236,0,99,0,1,290,3.448,3,2059,1.457,0,167,0,0,1528,0,0,1695,0,3,3754,0.799
2010,4,Cattaraugus,Rural,Commercial,4,13291,0.301,4,1260,3.175,1,2224,0.45,5,3484,1.435,9,16775,0.537,0,5770,0,0,109,0,0,5879,0,9,22654,0.397
2010,4,Cattaraugus,Rural,Medicaid,3,8529,0.352,6,853,7.034,1,1321,0.757,7,2174,3.22,10,10703,0.934,0,1361,0,0,33,0,0,1394,0,10,12097,0.827
2010,4,Cattaraugus,Rural,Medicare,0,5363,0,6,3223,1.862,0,1662,0,6,4885,1.228,6,10248,0.585,0,3635,0,0,55,0,0,3690,0,6,13938,0.43
2010,4,Cattaraugus,Rural,Other,0,1501,0,0,148,0,0,159,0,0,307,0,0,1808,0,0,323,0,0,7,0,0,330,0,0,2138,0
2010,5,Cayuga,Rural,Commercial,6,8085,0.742,1,882,1.134,1,1518,0.659,2,2400,0.833,8,10485,0.763,0,5018,0,0,1356,0,0,6374,0,8,16859,0.475
2011,5,Cayuga,Rural,Commercial,8,10015,0.799,8,931,8.593,2,2020,0.99,10,2951,3.389,18,12966,1.388,0,5810,0,3,15260,0.197,3,21070,0.142,21,34036,0.617
2010,5,Cayuga,Rural,Medicaid,5,5728,0.873,4,656,6.098,0,985,0,4,1641,2.438,9,7369,1.221,0,909,0,0,640,0,0,1549,0,9,8918,1.009
2013,5,Cayuga,Rural,Medicaid,6,5758,1.042,2,465,4.301,5,845,5.917,7,1310,5.344,13,7068,1.839,0,1096,0,0,4665,0,0,5761,0,13,12829,1.013
2010,5,Cayuga,Rural,Medicare,0,3710,0,1,2414,0.414,3,1271,2.36,4,3685,1.085,4,7395,0.541,0,2689,0,0,1086,0,0,3775,0,4,11170,0.358
2011,5,Cayuga,Rural,Medicare,3,4686,0.64,4,2356,1.698,3,2034,1.475,7,4390,1.595,10,9076,1.102,0,3140,0,3,7141,0.42,3,10281,0.292,13,19357,0.672
2010,5,Cayuga,Rural,Other,0,1076,0,0,159,0,0,145,0,0,304,0,0,1380,0,0,359,0,0,124,0,0,483,0,0,1863,0
2011,5,Cayuga,Rural,Other,1,1622,0.617,2,118,16.949,0,163,0,2,281,7.117,3,1903,1.576,0,386,0,1,1701,0.588,1,2087,0.479,4,3990,1.003
2012,5,Cayuga,Rural,Other,1,1167,0.857,1,174,5.747,1,165,6.061,2,339,5.9,3,1506,1.992,0,360,0,0,1498,0,0,1858,0,3,3364,0.892
2013,5,Cayuga,Rural,Other,0,1146,0,0,146,0,1,129,7.752,1,275,3.636,1,1421,0.704,0,463,0,0,1523,0,0,1986,0,1,3407,0.294
2010,6,Chautauqua,Rural,Medicaid,5,15027,0.333,5,1366,3.66,1,1815,0.551,6,3181,1.886,11,18208,0.604,0,2117,0,0,2,0,0,2119,0,11,20327,0.541
2010,6,Chautauqua,Rural,Medicare,4,8774,0.456,2,3677,0.544,0,1357,0,2,5034,0.397,6,13808,0.435,0,4990,0,0,4,0,0,4994,0,6,18802,0.319
2010,6,Chautauqua,Rural,Other,0,1446,0,1,119,8.403,0,140,0,1,259,3.861,1,1705,0.587,0,292,0,0,0,0,0,292,0,1,1997,0.501
2010,7,Chemung,Urban,Commercial,2,15008,0.133,4,1510,2.649,1,1901,0.526,5,3411,1.466,7,18419,0.38,0,4869,0,0,34,0,0,4903,0,7,23322,0.3
2011,7,Chemung,Urban,Commercial,2,20412,0.098,7,1483,4.72,0,1933,0,7,3416,2.049,9,23828,0.378,0,5784,0,0,16423,0,0,22207,0,9,46035,0.196
2012,7,Chemung,Urban,Commercial,6,22447,0.267,15,1588,9.446,2,2100,0.952,17,3688,4.61,23,26135,0.88,0,5513,0,0,15694,0,0,21207,0,23,47342,0.486
2010,7,Chemung,Urban,Medicaid,7,10601,0.66,14,1423,9.838,0,1682,0,14,3105,4.509,21,13706,1.532,0,1025,0,0,43,0,0,1068,0,21,14774,1.421
2011,7,Chemung,Urban,Medicaid,8,14776,0.541,10,1322,7.564,0,1621,0,10,2943,3.398,18,17719,1.016,0,1238,0,0,7047,0,0,8285,0,18,26004,0.692
2012,7,Chemung,Urban,Medicaid,5,12534,0.399,9,1143,7.874,0,1486,0,9,2629,3.423,14,15163,0.923,0,1072,0,0,5780,0,0,6852,0,14,22015,0.636
2010,7,Chemung,Urban,Medicare,0,5779,0,5,4627,1.081,3,1568,1.913,8,6195,1.291,8,11974,0.668,0,3573,0,0,24,0,0,3597,0,8,15571,0.514
2011,7,Chemung,Urban,Medicare,4,7497,0.534,9,4712,1.91,1,1402,0.713,10,6114,1.636,14,13611,1.029,0,4154,0,0,18447,0,0,22601,0,14,36212,0.387
2012,7,Chemung,Urban,Medicare,1,7679,0.13,9,4455,2.02,1,1453,0.688,10,5908,1.693,11,13587,0.81,0,3965,0,0,17629,0,0,21594,0,11,35181,0.313
2010,7,Chemung,Urban,Other,0,1158,0,2,256,7.813,0,123,0,2,379,5.277,2,1537,1.301,0,311,0,0,3,0,0,314,0,2,1851,1.08
2011,7,Chemung,Urban,Other,0,1480,0,1,225,4.444,1,105,9.524,2,330,6.061,2,1810,1.105,0,320,0,0,1711,0,0,2031,0,2,3841,0.521
2012,7,Chemung,Urban,Other,0,1310,0,0,209,0,0,101,0,0,310,0,0,1620,0,0,250,0,0,1603,0,0,1853,0,0,3473,0
2010,8,Chenango,Rural,Commercial,4,10191,0.393,3,738,4.065,1,1202,0.832,4,1940,2.062,8,12131,0.659,0,4206,0,0,161,0,0,4367,0,8,16498,0.485
2010,8,Chenango,Rural,Medicaid,5,7847,0.637,3,426,7.042,4,787,5.083,7,1213,5.771,12,9060,1.325,0,994,0,0,38,0,0,1032,0,12,10092,1.189
2010,8,Chenango,Rural,Medicare,1,4360,0.229,6,1724,3.48,1,948,1.055,7,2672,2.62,8,7032,1.138,0,3028,0,0,114,0,0,3142,0,8,10174,0.786
2010,8,Chenango,Rural,Other,0,268,0,0,65,0,1,65,15.385,1,130,7.692,1,398,2.513,0,98,0,0,6,0,0,104,0,1,502,1.992
2011,8,Chenango,Rural,Other,0,453,0,0,85,0,0,64,0,0,149,0,0,602,0,0,74,0,0,860,0,0,934,0,0,1536,0
2012,8,Chenango,Rural,Other,0,595,0,0,76,0,0,48,0,0,124,0,0,719,0,0,70,0,0,523,0,0,593,0,0,1312,0
2013,8,Chenango,Rural,Other,0,523,0,1,54,18.519,0,41,0,1,95,10.526,1,618,1.618,0,94,0,0,793,0,0,887,0,1,1505,0.664
2012,9,Clinton,Rural,Medicaid,0,4139,0,8,498,16.064,0,460,0,8,958,8.351,8,5097,1.57,0,768,0,0,4034,0,0,4802,0,8,9899,0.808
2010,9,Clinton,Rural,Medicare,2,4958,0.403,6,3167,1.895,0,806,0,6,3973,1.51,8,8931,0.896,0,4946,0,0,2,0,0,4948,0,8,13879,0.576
2010,9,Clinton,Rural,Other,0,58,0,0,28,0,0,43,0,0,71,0,0,129,0,0,210,0,0,0,0,0,210,0,0,339,0
2011,9,Clinton,Rural,Other,0,72,0,0,41,0,0,23,0,0,64,0,0,136,0,0,241,0,0,91,0,0,332,0,0,468,0
2012,9,Clinton,Rural,Other,0,52,0,0,56,0,0,32,0,0,88,0,0,140,0,0,186,0,0,71,0,0,257,0,0,397,0
2013,9,Clinton,Rural,Other,0,138,0,1,62,16.129,0,29,0,1,91,10.989,1,229,4.367,0,187,0,0,104,0,0,291,0,1,520,1.923
2010,10,Columbia,Rural,Medicaid,2,4165,0.48,3,542,5.535,1,658,1.52,4,1200,3.333,6,5365,1.118,0,631,0,0,1,0,0,632,0,6,5997,1.001
2010,10,Columbia,Rural,Medicare,1,3497,0.286,3,2437,1.231,0,869,0,3,3306,0.907,4,6803,0.588,0,2231,0,0,4,0,0,2235,0,4,9038,0.443
2010,10,Columbia,Rural,Other,0,490,0,0,64,0,0,35,0,0,99,0,0,589,0,0,106,0,0,0,0,0,106,0,0,695,0
2011,10,Columbia,Rural,Other,0,565,0,0,86,0,0,25,0,0,111,0,0,676,0,0,138,0,0,473,0,0,611,0,0,1287,0
2012,10,Columbia,Rural,Other,0,613,0,0,78,0,0,30,0,0,108,0,0,721,0,0,96,0,0,496,0,0,592,0,0,1313,0
2013,10,Columbia,Rural,Other,0,632,0,0,65,0,0,35,0,0,100,0,0,732,0,0,119,0,0,513,0,0,632,0,0,1364,0
2014,10,Columbia,Rural,Other,1,607,1.647,0,70,0,0,20,0,0,90,0,1,697,1.435,0,117,0,0,410,0,0,527,0,1,1224,0.817
2010,11,Cortland,Rural,Commercial,3,5297,0.566,3,696,4.31,0,947,0,3,1643,1.826,6,6940,0.865,0,1766,0,0,22,0,0,1788,0,6,8728,0.687
2010,11,Cortland,Rural,Medicaid,4,4801,0.833,6,566,10.601,0,751,0,6,1317,4.556,10,6118,1.635,0,395,0,0,10,0,0,405,0,10,6523,1.533
2010,11,Cortland,Rural,Medicare,0,2734,0,4,2005,1.995,0,719,0,4,2724,1.468,4,5458,0.733,0,879,0,0,6,0,0,885,0,4,6343,0.631
2011,11,Cortland,Rural,Medicare,2,3810,0.525,1,2299,0.435,0,749,0,1,3048,0.328,3,6858,0.437,0,1256,0,0,3508,0,0,4764,0,3,11622,0.258
2010,11,Cortland,Rural,Other,0,304,0,0,56,0,0,44,0,0,100,0,0,404,0,0,46,0,0,2,0,0,48,0,0,452,0
2011,11,Cortland,Rural,Other,1,5008,0.2,1,100,10,0,33,0,1,133,7.519,2,5141,0.389,0,105,0,0,159,0,0,264,0,2,5405,0.37
2013,11,Cortland,Rural,Other,0,381,0,0,44,0,0,33,0,0,77,0,0,458,0,0,98,0,0,146,0,0,244,0,0,702,0
2010,12,Delaware,Rural,Commercial,1,7667,0.13,2,562,3.559,1,953,1.049,3,1515,1.98,4,9182,0.436,0,4285,0,0,142,0,0,4427,0,4,13609,0.294
2010,12,Delaware,Rural,Medicaid,5,5334,0.937,4,319,12.539,2,657,3.044,6,976,6.148,11,6310,1.743,0,916,0,0,38,0,0,954,0,11,7264,1.514
2010,12,Delaware,Rural,Medicare,2,4799,0.417,2,1101,1.817,5,1671,2.992,7,2772,2.525,9,7571,1.189,0,4641,0,0,116,0,0,4757,0,9,12328,0.73
2010,12,Delaware,Rural,Other,1,449,2.227,0,172,0,0,179,0,0,351,0,1,800,1.25,0,134,0,0,2,0,0,136,0,1,936,1.068
2011,12,Delaware,Rural,Other,0,539,0,4,141,28.369,0,151,0,4,292,13.699,4,831,4.813,0,88,0,0,1016,0,0,1104,0,4,1935,2.067
2013,12,Delaware,Rural,Other,0,538,0,0,39,0,0,38,0,0,77,0,0,615,0,0,60,0,0,761,0,0,821,0,0,1436,0
2010,13,Dutchess,Urban,Medicaid,15,15468,0.97,18,1072,16.791,4,3789,1.056,22,4861,4.526,37,20329,1.82,0,1388,0,0,4,0,0,1392,0,37,21721,1.703
2010,13,Dutchess,Urban,Medicare,8,13043,0.613,8,4191,1.909,6,9724,0.617,14,13915,1.006,22,26958,0.816,0,7442,0,0,12,0,0,7454,0,22,34412,0.639
2010,13,Dutchess,Urban,Other,2,2962,0.675,1,490,2.041,0,697,0,1,1187,0.842,3,4149,0.723,0,2275,0,0,0,0,0,2275,0,3,6424,0.467
2011,13,Dutchess,Urban,Other,0,3410,0,1,814,1.229,0,482,0,1,1296,0.772,1,4706,0.212,0,2664,0,0,1343,0,0,4007,0,1,8713,0.115
2012,13,Dutchess,Urban,Other,4,4155,0.963,1,712,1.404,0,310,0,1,1022,0.978,5,5177,0.966,0,2808,0,0,1696,0,0,4504,0,5,9681,0.516
2013,13,Dutchess,Urban,Other,3,3962,0.757,3,680,4.412,0,248,0,3,928,3.233,6,4890,1.227,0,2596,0,0,1689,0,0,4285,0,6,9175,0.654
2010,14,Erie,Urban,Medicaid,95,99491,0.955,69,11355,6.077,2,13412,0.149,71,24767,2.867,166,124258,1.336,0,12476,0,0,11,0,0,12487,0,166,136745,1.214
2010,14,Erie,Urban,Medicare,35,46454,0.753,62,34529,1.796,3,11221,0.267,65,45750,1.421,100,92204,1.085,0,30262,0,0,12,0,0,30274,0,100,122478,0.816
2010,14,Erie,Urban,Other,5,12836,0.39,5,1180,4.237,0,875,0,5,2055,2.433,10,14891,0.672,0,1898,0,0,5,0,0,1903,0,10,16794,0.595
2010,15,Essex,Rural,Commercial,6,7528,0.797,5,569,8.787,0,682,0,5,1251,3.997,11,8779,1.253,0,2322,0,0,1,0,0,2323,0,11,11102,0.991
2013,15,Essex,Rural,Commercial,3,7120,0.421,1,419,2.387,0,565,0,1,984,1.016,4,8104,0.494,0,2145,0,0,7808,0,0,9953,0,4,18057,0.222
2010,15,Essex,Rural,Medicaid,1,2744,0.364,2,254,7.874,0,368,0,2,622,3.215,3,3366,0.891,0,284,0,0,2,0,0,286,0,3,3652,0.821
2011,15,Essex,Rural,Medicaid,2,3407,0.587,3,246,12.195,0,247,0,3,493,6.085,5,3900,1.282,0,358,0,0,2607,0,0,2965,0,5,6865,0.728
2013,15,Essex,Rural,Medicaid,4,4167,0.96,1,188,5.319,1,222,4.505,2,410,4.878,6,4577,1.311,0,408,0,0,2763,0,0,3171,0,6,7748,0.774
2010,15,Essex,Rural,Medicare,0,2174,0,2,1133,1.765,0,750,0,2,1883,1.062,2,4057,0.493,0,1482,0,0,0,0,0,1482,0,2,5539,0.361
2013,15,Essex,Rural,Medicare,4,4242,0.943,0,807,0,0,692,0,0,1499,0,4,5741,0.697,0,1622,0,0,7026,0,0,8648,0,4,14389,0.278
2010,15,Essex,Rural,Other,0,267,0,1,48,20.833,0,18,0,1,66,15.152,1,333,3.003,0,96,0,0,0,0,0,96,0,1,429,2.331
2011,15,Essex,Rural,Other,0,276,0,0,27,0,0,24,0,0,51,0,0,327,0,0,94,0,0,252,0,0,346,0,0,673,0
2012,15,Essex,Rural,Other,0,281,0,0,30,0,0,14,0,0,44,0,0,325,0,0,98,0,0,147,0,0,245,0,0,570,0
2013,15,Essex,Rural,Other,0,272,0,0,24,0,0,19,0,0,43,0,0,315,0,0,68,0,0,112,0,0,180,0,0,495,0
2014,15,Essex,Rural,Other,0,339,0,0,30,0,0,22,0,0,52,0,0,391,0,0,82,0,0,124,0,0,206,0,0,597,0
2010,16,Franklin,Rural,Commercial,3,8046,0.373,6,1008,5.952,0,1038,0,6,2046,2.933,9,10092,0.892,0,3097,0,0,3,0,0,3100,0,9,13192,0.682
2010,16,Franklin,Rural,Medicaid,0,5492,0,4,678,5.9,0,746,0,4,1424,2.809,4,6916,0.578,0,733,0,0,0,0,0,733,0,4,7649,0.523
2012,16,Franklin,Rural,Medicaid,1,2172,0.46,4,208,19.231,0,252,0,4,460,8.696,5,2632,1.9,0,293,0,0,1787,0,0,2080,0,5,4712,1.061
2013,16,Franklin,Rural,Medicaid,1,2056,0.486,0,174,0,0,243,0,0,417,0,1,2473,0.404,0,312,0,0,1696,0,0,2008,0,1,4481,0.223
2010,16,Franklin,Rural,Medicare,0,3159,0,7,1941,3.606,1,495,2.02,8,2436,3.284,8,5595,1.43,0,1873,0,0,1,0,0,1874,0,8,7469,1.071
2013,16,Franklin,Rural,Medicare,0,1729,0,4,702,5.698,0,385,0,4,1087,3.68,4,2816,1.42,0,940,0,0,2966,0,0,3906,0,4,6722,0.595
2010,16,Franklin,Rural,Other,0,1209,0,0,205,0,0,116,0,0,321,0,0,1530,0,0,544,0,0,2,0,0,546,0,0,2076,0
2013,16,Franklin,Rural,Other,0,1042,0,0,107,0,0,97,0,0,204,0,0,1246,0,0,230,0,0,483,0,0,713,0,0,1959,0
2014,16,Franklin,Rural,Other,1,995,1.005,0,130,0,0,70,0,0,200,0,1,1195,0.837,0,245,0,0,506,0,0,751,0,1,1946,0.514
2010,17,Fulton,Rural,Commercial,3,7331,0.409,2,942,2.123,1,1179,0.848,3,2121,1.414,6,9452,0.635,0,4798,0,0,1,0,0,4799,0,6,14251,0.421
2012,17,Fulton,Rural,Commercial,5,6714,0.745,1,800,1.25,1,1114,0.898,2,1914,1.045,7,8628,0.811,0,4609,0,0,7196,0,0,11805,0,7,20433,0.343
2010,17,Fulton,Rural,Medicaid,3,6567,0.457,1,946,1.057,1,1132,0.883,2,2078,0.962,5,8645,0.578,0,1468,0,0,0,0,0,1468,0,5,10113,0.494
2012,17,Fulton,Rural,Medicaid,0,4501,0,3,775,3.871,1,944,1.059,4,1719,2.327,4,6220,0.643,0,1633,0,0,3785,0,0,5418,0,4,11638,0.344
2013,17,Fulton,Rural,Medicaid,4,10067,0.397,4,820,4.878,0,978,0,4,1798,2.225,8,11865,0.674,0,1594,0,0,6172,0,0,7766,0,8,19631,0.408
2010,17,Fulton,Rural,Medicare,0,3254,0,1,2544,0.393,0,1067,0,1,3611,0.277,1,6865,0.146,0,3058,0,0,0,0,0,3058,0,1,9923,0.101
2012,17,Fulton,Rural,Medicare,1,2711,0.369,7,2405,2.911,2,1202,1.664,9,3607,2.495,10,6318,1.583,0,3374,0,0,6319,0,0,9693,0,10,16011,0.625
2010,17,Fulton,Rural,Other,0,668,0,0,76,0,0,42,0,0,118,0,0,786,0,0,156,0,0,0,0,0,156,0,0,942,0
2011,17,Fulton,Rural,Other,0,316,0,0,74,0,0,64,0,0,138,0,0,454,0,0,137,0,0,337,0,0,474,0,0,928,0
2012,17,Fulton,Rural,Other,0,376,0,1,68,14.706,0,46,0,1,114,8.772,1,490,2.041,0,171,0,0,305,0,0,476,0,1,966,1.035
2014,17,Fulton,Rural,Other,0,763,0,0,62,0,0,66,0,0,128,0,0,891,0,0,158,0,0,480,0,0,638,0,0,1529,0
2010,18,Genesee,Rural,Commercial,4,9884,0.405,8,1143,6.999,0,1809,0,8,2952,2.71,12,12836,0.935,0,4710,0,0,93,0,0,4803,0,12,17639,0.68
2010,18,Genesee,Rural,Medicaid,2,5523,0.362,5,384,13.021,0,683,0,5,1067,4.686,7,6590,1.062,0,570,0,0,21,0,0,591,0,7,7181,0.975
2010,18,Genesee,Rural,Medicare,3,3392,0.884,2,2521,0.793,0,1013,0,2,3534,0.566,5,6926,0.722,0,2659,0,0,58,0,0,2717,0,5,9643,0.519
2010,18,Genesee,Rural,Other,0,706,0,0,77,0,0,50,0,0,127,0,0,833,0,0,92,0,0,24,0,0,116,0,0,949,0
2012,18,Genesee,Rural,Other,0,873,0,1,91,10.989,0,50,0,1,141,7.092,1,1014,0.986,0,139,0,0,444,0,0,583,0,1,1597,0.626
2013,18,Genesee,Rural,Other,3,792,3.788,0,76,0,0,49,0,0,125,0,3,917,3.272,0,136,0,0,554,0,0,690,0,3,1607,1.867
2010,19,Greene,Rural,Commercial,2,6017,0.332,3,989,3.033,0,1169,0,3,2158,1.39,5,8175,0.612,0,3415,0,0,3,0,0,3418,0,5,11593,0.431
2010,19,Greene,Rural,Medicaid,1,2085,0.48,8,478,16.736,0,630,0,8,1108,7.22,9,3193,2.819,0,554,0,0,1,0,0,555,0,9,3748,2.401
2010,19,Greene,Rural,Medicare,2,1988,1.006,4,2023,1.977,1,726,1.377,5,2749,1.819,7,4737,1.478,0,1915,0,0,32,0,0,1947,0,7,6684,1.047
2012,19,Greene,Rural,Medicare,1,2546,0.393,4,2199,1.819,0,670,0,4,2869,1.394,5,5415,0.923,0,2295,0,0,3464,0,0,5759,0,5,11174,0.447
2010,19,Greene,Rural,Other,0,357,0,0,111,0,0,95,0,0,206,0,0,563,0,0,303,0,0,1,0,0,304,0,0,867,0
2011,19,Greene,Rural,Other,0,473,0,0,180,0,0,74,0,0,254,0,0,727,0,0,299,0,0,578,0,0,877,0,0,1604,0
2012,19,Greene,Rural,Other,0,481,0,0,169,0,0,66,0,0,235,0,0,716,0,0,269,0,0,403,0,0,672,0,0,1388,0
2013,19,Greene,Rural,Other,1,509,1.965,0,153,0,0,82,0,0,235,0,1,744,1.344,0,286,0,0,741,0,0,1027,0,1,1771,0.565
2010,20,Hamilton,Rural,Commercial,1,315,3.175,0,77,0,0,92,0,0,169,0,1,484,2.066,0,358,0,0,2,0,0,360,0,1,844,1.185
2011,20,Hamilton,Rural,Commercial,0,260,0,0,75,0,0,73,0,0,148,0,0,408,0,0,361,0,0,395,0,0,756,0,0,1164,0
2012,20,Hamilton,Rural,Commercial,0,364,0,1,73,13.699,0,93,0,1,166,6.024,1,530,1.887,0,329,0,0,361,0,0,690,0,1,1220,0.82
2013,20,Hamilton,Rural,Commercial,0,432,0,0,62,0,0,94,0,0,156,0,0,588,0,0,390,0,0,509,0,0,899,0,0,1487,0
2010,20,Hamilton,Rural,Medicaid,0,93,0,0,30,0,0,45,0,0,75,0,0,168,0,0,45,0,0,0,0,0,45,0,0,213,0
2011,20,Hamilton,Rural,Medicaid,0,107,0,0,29,0,0,46,0,0,75,0,0,182,0,0,47,0,0,128,0,0,175,0,0,357,0
2012,20,Hamilton,Rural,Medicaid,0,101,0,0,29,0,0,34,0,0,63,0,0,164,0,0,35,0,0,102,0,0,137,0,0,301,0
2013,20,Hamilton,Rural,Medicaid,1,161,6.211,1,24,41.667,0,32,0,1,56,17.857,2,217,9.217,0,46,0,0,136,0,0,182,0,2,399,5.013
2014,20,Hamilton,Rural,Medicaid,1,187,5.348,0,27,0,0,36,0,0,63,0,1,250,4,0,64,0,0,170,0,0,234,0,1,484,2.066
2010,20,Hamilton,Rural,Medicare,0,161,0,0,193,0,0,102,0,0,295,0,0,456,0,0,285,0,0,0,0,0,285,0,0,741,0
2011,20,Hamilton,Rural,Medicare,0,182,0,0,187,0,0,118,0,0,305,0,0,487,0,0,380,0,0,449,0,0,829,0,0,1316,0
2012,20,Hamilton,Rural,Medicare,0,219,0,0,164,0,0,107,0,0,271,0,0,490,0,0,373,0,0,457,0,0,830,0,0,1320,0
2013,20,Hamilton,Rural,Medicare,0,338,0,0,159,0,0,100,0,0,259,0,0,597,0,0,369,0,0,587,0,0,956,0,0,1553,0
2010,20,Hamilton,Rural,Other,0,32,0,0,5,0,0,3,0,0,8,0,0,40,0,0,12,0,0,0,0,0,12,0,0,52,0
2011,20,Hamilton,Rural,Other,1,30,33.333,0,7,0,0,4,0,0,11,0,1,41,24.39,0,14,0,0,28,0,0,42,0,1,83,12.048
2012,20,Hamilton,Rural,Other,0,18,0,0,8,0,0,4,0,0,12,0,0,30,0,0,16,0,0,38,0,0,54,0,0,84,0
2013,20,Hamilton,Rural,Other,0,31,0,0,8,0,0,4,0,0,12,0,0,43,0,0,11,0,0,28,0,0,39,0,0,82,0
2014,20,Hamilton,Rural,Other,0,35,0,0,4,0,0,4,0,0,8,0,0,43,0,0,5,0,0,22,0,0,27,0,0,70,0
2010,21,Herkimer,Urban,Commercial,6,7053,0.851,3,877,3.421,2,1377,1.452,5,2254,2.218,11,9307,1.182,0,6570,0,0,6,0,0,6576,0,11,15883,0.693
2012,21,Herkimer,Urban,Commercial,2,8436,0.237,5,837,5.974,4,1223,3.271,9,2060,4.369,11,10496,1.048,0,4621,0,0,6205,0,0,10826,0,11,21322,0.516
2010,21,Herkimer,Urban,Medicaid,8,6097,1.312,5,555,9.009,4,1090,3.67,9,1645,5.471,17,7742,2.196,0,2110,0,0,5,0,0,2115,0,17,9857,1.725
2012,21,Herkimer,Urban,Medicaid,2,7265,0.275,7,682,10.264,0,960,0,7,1642,4.263,9,8907,1.01,0,1197,0,0,5381,0,0,6578,0,9,15485,0.581
2010,21,Herkimer,Urban,Medicare,2,3802,0.526,6,2694,2.227,4,1504,2.66,10,4198,2.382,12,8000,1.5,0,5516,0,0,5,0,0,5521,0,12,13521,0.888
2013,21,Herkimer,Urban,Medicare,1,4815,0.208,3,2096,1.431,0,1665,0,3,3761,0.798,4,8576,0.466,0,2954,0,0,30069,0,0,33023,0,4,41599,0.096
2010,21,Herkimer,Urban,Other,0,574,0,1,68,14.706,0,51,0,1,119,8.403,1,693,1.443,0,167,0,0,0,0,0,167,0,1,860,1.163
2011,21,Herkimer,Urban,Other,0,879,0,0,106,0,0,65,0,0,171,0,0,1050,0,0,168,0,0,817,0,0,985,0,0,2035,0
2012,21,Herkimer,Urban,Other,1,920,1.087,0,107,0,0,74,0,0,181,0,1,1101,0.908,0,118,0,0,440,0,0,558,0,1,1659,0.603
2013,21,Herkimer,Urban,Other,0,879,0,0,70,0,0,59,0,0,129,0,0,1008,0,0,129,0,0,633,0,0,762,0,0,1770,0
2010,22,Jefferson,Urban,Commercial,1,12047,0.083,4,1148,3.484,0,2040,0,4,3188,1.255,5,15235,0.328,0,4965,0,0,124,0,0,5089,0,5,20324,0.246
2010,22,Jefferson,Urban,Medicaid,3,8947,0.335,1,842,1.188,1,1650,0.606,2,2492,0.803,5,11439,0.437,0,1236,0,0,22,0,0,1258,0,5,12697,0.394
2010,22,Jefferson,Urban,Medicare,0,4320,0,4,2794,1.432,0,1604,0,4,4398,0.91,4,8718,0.459,0,3485,0,0,41,0,0,3526,0,4,12244,0.327
2010,22,Jefferson,Urban,Other,1,11100,0.09,4,943,4.242,1,2624,0.381,5,3567,1.402,6,14667,0.409,0,3263,0,0,21,0,0,3284,0,6,17951,0.334
2010,23,Lewis,Rural,Commercial,0,4575,0,1,457,2.188,0,806,0,1,1263,0.792,1,5838,0.171,0,1666,0,0,23,0,0,1689,0,1,7527,0.133
2010,23,Lewis,Rural,Medicaid,1,2239,0.447,1,185,5.405,1,383,2.611,2,568,3.521,3,2807,1.069,0,287,0,0,1,0,0,288,0,3,3095,0.969
2012,23,Lewis,Rural,Medicaid,2,1990,1.005,1,103,9.709,0,123,0,1,226,4.425,3,2216,1.354,0,302,0,0,1018,0,0,1320,0,3,3536,0.848
2010,23,Lewis,Rural,Medicare,0,1320,0,0,646,0,0,510,0,0,1156,0,0,2476,0,0,870,0,0,10,0,0,880,0,0,3356,0
2012,23,Lewis,Rural,Medicare,0,1286,0,0,234,0,0,395,0,0,629,0,0,1915,0,0,732,0,0,1869,0,0,2601,0,0,4516,0
2013,23,Lewis,Rural,Medicare,0,453,0,0,199,0,1,390,2.564,1,589,1.698,1,1042,0.96,0,697,0,0,1095,0,0,1792,0,1,2834,0.353
2010,23,Lewis,Rural,Other,0,591,0,0,51,0,0,75,0,0,126,0,0,717,0,0,141,0,0,2,0,0,143,0,0,860,0
2012,23,Lewis,Rural,Other,1,744,1.344,0,40,0,0,76,0,0,116,0,1,860,1.163,0,128,0,0,452,0,0,580,0,1,1440,0.694
2013,23,Lewis,Rural,Other,0,331,0,1,41,24.39,0,57,0,1,98,10.204,1,429,2.331,0,142,0,0,348,0,0,490,0,1,919,1.088
2010,24,Livingston,Urban,Commercial,4,8455,0.473,3,853,3.517,0,1608,0,3,2461,1.219,7,10916,0.641,0,3960,0,0,162,0,0,4122,0,7,15038,0.465
2010,24,Livingston,Urban,Medicare,2,2644,0.756,1,1584,0.631,0,868,0,1,2452,0.408,3,5096,0.589,0,2132,0,0,112,0,0,2244,0,3,7340,0.409
2012,24,Livingston,Urban,Medicare,2,3385,0.591,10,1867,5.356,0,768,0,10,2635,3.795,12,6020,1.993,0,2873,0,0,5692,0,0,8565,0,12,14585,0.823
2010,24,Livingston,Urban,Other,0,660,0,2,116,17.241,0,86,0,2,202,9.901,2,862,2.32,0,233,0,0,45,0,0,278,0,2,1140,1.754
2011,24,Livingston,Urban,Other,1,762,1.312,1,96,10.417,0,46,0,1,142,7.042,2,904,2.212,0,168,0,0,402,0,0,570,0,2,1474,1.357
2010,25,Madison,Urban,Commercial,8,10581,0.756,1,930,1.075,0,1609,0,1,2539,0.394,9,13120,0.686,0,5476,0,0,48,0,0,5524,0,9,18644,0.483
2010,25,Madison,Urban,Medicaid,5,8132,0.615,3,419,7.16,0,894,0,3,1313,2.285,8,9445,0.847,0,964,0,0,11,0,0,975,0,8,10420,0.768
2011,25,Madison,Urban,Medicaid,4,7989,0.501,5,446,11.211,1,835,1.198,6,1281,4.684,10,9270,1.079,0,1053,0,0,5844,0,0,6897,0,10,16167,0.619
2010,25,Madison,Urban,Medicare,0,3760,0,1,1871,0.534,0,1058,0,1,2929,0.341,1,6689,0.149,0,3128,0,0,14,0,0,3142,0,1,9831,0.102
2011,25,Madison,Urban,Medicare,1,3938,0.254,3,1908,1.572,1,1014,0.986,4,2922,1.369,5,6860,0.729,0,2766,0,0,8138,0,0,10904,0,5,17764,0.281
2010,25,Madison,Urban,Other,1,916,1.092,0,66,0,0,67,0,0,133,0,1,1049,0.953,0,168,0,0,1,0,0,169,0,1,1218,0.821
2011,25,Madison,Urban,Other,0,930,0,0,66,0,0,59,0,0,125,0,0,1055,0,0,137,0,0,471,0,0,608,0,0,1663,0
2012,25,Madison,Urban,Other,0,736,0,0,96,0,0,79,0,0,175,0,0,911,0,0,123,0,0,306,0,0,429,0,0,1340,0
2013,25,Madison,Urban,Other,1,806,1.241,0,76,0,0,62,0,0,138,0,1,944,1.059,0,181,0,0,340,0,0,521,0,1,1465,0.683
2010,26,Monroe,Urban,Commercial,49,92079,0.532,34,12613,2.696,3,19275,0.156,37,31888,1.16,86,123967,0.694,1,48101,0.021,0,1793,0,1,49894,0.02,87,173861,0.5
2010,26,Monroe,Urban,Medicare,20,35203,0.568,53,24086,2.2,0,8158,0,53,32244,1.644,73,67447,1.082,0,20963,0,0,1744,0,0,22707,0,73,90154,0.81
2010,26,Monroe,Urban,Other,4,5468,0.732,2,670,2.985,0,492,0,2,1162,1.721,6,6630,0.905,0,1497,0,0,900,0,0,2397,0,6,9027,0.665
2013,26,Monroe,Urban,Other,5,6536,0.765,3,687,4.367,0,430,0,3,1117,2.686,8,7653,1.045,0,1277,0,0,4221,0,0,5498,0,8,13151,0.608
2010,27,Montgomery,Rural,Commercial,3,8934,0.336,5,890,5.618,0,1081,0,5,1971,2.537,8,10905,0.734,0,5361,0,0,1,0,0,5362,0,8,16267,0.492
2010,27,Montgomery,Rural,Medicaid,8,8497,0.942,4,746,5.362,3,1058,2.836,7,1804,3.88,15,10301,1.456,0,1749,0,0,0,0,0,1749,0,15,12050,1.245
2011,27,Montgomery,Rural,Medicaid,5,10537,0.475,5,685,7.299,0,1060,0,5,1745,2.865,10,12282,0.814,0,1605,0,0,19006,0,0,20611,0,10,32893,0.304
2012,27,Montgomery,Rural,Medicaid,3,11226,0.267,5,631,7.924,0,909,0,5,1540,3.247,8,12766,0.627,0,1548,0,0,14590,0,0,16138,0,8,28904,0.277
2013,27,Montgomery,Rural,Medicaid,5,11669,0.428,1,641,1.56,0,982,0,1,1623,0.616,6,13292,0.451,0,1535,0,0,17797,0,0,19332,0,6,32624,0.184
2010,27,Montgomery,Rural,Medicare,2,4407,0.454,3,2488,1.206,1,1005,0.995,4,3493,1.145,6,7900,0.759,0,3982,0,0,0,0,0,3982,0,6,11882,0.505
2011,27,Montgomery,Rural,Medicare,2,5274,0.379,4,2386,1.676,1,1032,0.969,5,3418,1.463,7,8692,0.805,0,3771,0,0,18764,0,0,22535,0,7,31227,0.224
2012,27,Montgomery,Rural,Medicare,3,5954,0.504,6,2295,2.614,1,1082,0.924,7,3377,2.073,10,9331,1.072,0,3403,0,0,15324,0,0,18727,0,10,28058,0.356
2010,27,Montgomery,Rural,Other,0,790,0,0,84,0,0,58,0,0,142,0,0,932,0,0,149,0,0,0,0,0,149,0,0,1081,0
2011,27,Montgomery,Rural,Other,0,741,0,1,61,16.393,0,43,0,1,104,9.615,1,845,1.183,0,160,0,0,823,0,0,983,0,1,1828,0.547
2012,27,Montgomery,Rural,Other,0,677,0,0,52,0,0,35,0,0,87,0,0,764,0,0,144,0,0,542,0,0,686,0,0,1450,0
2013,27,Montgomery,Rural,Other,0,806,0,0,54,0,0,56,0,0,110,0,0,916,0,0,110,0,0,729,0,0,839,0,0,1755,0
2014,27,Montgomery,Rural,Other,0,728,0,0,62,0,0,47,0,0,109,0,0,837,0,0,98,0,0,638,0,0,736,0,0,1573,0
2010,29,Niagara,Urban,Commercial,18,35439,0.508,35,5676,6.166,0,6476,0,35,12152,2.88,53,47591,1.114,0,19252,0,0,62,0,0,19314,0,53,66905,0.792
2010,29,Niagara,Urban,Medicaid,18,20193,0.891,31,2979,10.406,2,2694,0.742,33,5673,5.817,51,25866,1.972,0,3081,0,0,15,0,0,3096,0,51,28962,1.761
2010,29,Niagara,Urban,Medicare,4,11000,0.364,22,8631,2.549,3,3406,0.881,25,12037,2.077,29,23037,1.259,0,10813,0,0,10,0,0,10823,0,29,33860,0.856
2010,29,Niagara,Urban,Other,1,2488,0.402,2,245,8.163,0,247,0,2,492,4.065,3,2980,1.007,0,439,0,0,5,0,0,444,0,3,3424,0.876
2010,30,Oneida,Urban,Commercial,11,26093,0.422,23,3347,6.872,2,5649,0.354,25,8996,2.779,36,35089,1.026,0,19549,0,0,74,0,0,19623,0,36,54712,0.658
2010,30,Oneida,Urban,Medicare,5,12513,0.4,21,10244,2.05,2,5526,0.362,23,15770,1.458,28,28283,0.99,0,13098,0,0,42,0,0,13140,0,28,41423,0.676
2012,30,Oneida,Urban,Medicare,6,16836,0.356,22,11320,1.943,1,4137,0.242,23,15457,1.488,29,32293,0.898,0,11446,0,1,21171,0.047,1,32617,0.031,30,64910,0.462
2010,30,Oneida,Urban,Other,2,3613,0.554,3,522,5.747,0,344,0,3,866,3.464,5,4479,1.116,0,861,0,0,2,0,0,863,0,5,5342,0.936
2011,30,Oneida,Urban,Other,3,6108,0.491,0,575,0,1,451,2.217,1,1026,0.975,4,7134,0.561,0,886,0,0,2800,0,0,3686,0,4,10820,0.37
2010,31,Onondaga,Urban,Commercial,34,47876,0.71,25,6636,3.767,0,10270,0,25,16906,1.479,59,64782,0.911,0,25829,0,0,2947,0,0,28776,0,59,93558,0.631
2010,31,Onondaga,Urban,Medicaid,39,34967,1.115,30,4915,6.104,2,6633,0.302,32,11548,2.771,71,46515,1.526,0,3788,0,0,254,0,0,4042,0,71,50557,1.404
2010,31,Onondaga,Urban,Medicare,12,17254,0.695,22,15149,1.452,1,5025,0.199,23,20174,1.14,35,37428,0.935,0,11336,0,0,1287,0,0,12623,0,35,50051,0.699
2010,31,Onondaga,Urban,Other,1,4084,0.245,2,472,4.237,0,374,0,2,846,2.364,3,4930,0.609,0,884,0,0,82,0,0,966,0,3,5896,0.509
2010,32,Ontario,Urban,Commercial,8,13429,0.596,6,1569,3.824,2,2775,0.721,8,4344,1.842,16,17773,0.9,0,8359,0,0,140,0,0,8499,0,16,26272,0.609
2010,32,Ontario,Urban,Medicaid,4,6820,0.587,8,623,12.841,0,994,0,8,1617,4.947,12,8437,1.422,0,1251,0,0,65,0,0,1316,0,12,9753,1.23
2012,32,Ontario,Urban,Medicaid,7,8638,0.81,7,624,11.218,1,1003,0.997,8,1627,4.917,15,10265,1.461,0,1524,0,0,3340,0,0,4864,0,15,15129,0.991
2010,32,Ontario,Urban,Medicare,3,5475,0.548,11,3751,2.933,0,1357,0,11,5108,2.153,14,10583,1.323,0,4495,0,0,72,0,0,4567,0,14,15150,0.924
2010,32,Ontario,Urban,Other,1,1065,0.939,1,241,4.149,0,70,0,1,311,3.215,2,1376,1.453,0,341,0,0,28,0,0,369,0,2,1745,1.146
2011,32,Ontario,Urban,Other,0,1148,0,0,215,0,0,88,0,0,303,0,0,1451,0,0,240,0,0,592,0,0,832,0,0,2283,0
2012,32,Ontario,Urban,Other,4,2062,1.94,0,247,0,0,77,0,0,324,0,4,2386,1.676,0,285,0,0,701,0,0,986,0,4,3372,1.186
2013,32,Ontario,Urban,Other,3,2477,1.211,2,312,6.41,1,111,9.009,3,423,7.092,6,2900,2.069,0,597,0,0,740,0,0,1337,0,6,4237,1.416
2010,33,Orange,Urban,Commercial,20,43830,0.456,22,6862,3.206,1,10455,0.096,23,17317,1.328,43,61147,0.703,0,18891,0,0,17,0,0,18908,0,43,80055,0.537
2010,33,Orange,Urban,Medicaid,21,25659,0.818,26,4004,6.494,2,6063,0.33,28,10067,2.781,49,35726,1.372,0,3275,0,0,11,0,0,3286,0,49,39012,1.256
2010,33,Orange,Urban,Medicare,14,12656,1.106,15,11410,1.315,3,5812,0.516,18,17222,1.045,32,29878,1.071,0,7835,0,0,5,0,0,7840,0,32,37718,0.848
2010,33,Orange,Urban,Other,0,2657,0,3,576,5.208,0,485,0,3,1061,2.828,3,3718,0.807,0,661,0,0,1,0,0,662,0,3,4380,0.685
2012,33,Orange,Urban,Other,7,8846,0.791,4,600,6.667,1,408,2.451,5,1008,4.96,12,9854,1.218,0,1107,0,0,2594,0,0,3701,0,12,13555,0.885
2013,33,Orange,Urban,Other,1,4537,0.22,1,593,1.686,0,382,0,1,975,1.026,2,5512,0.363,0,931,0,0,1786,0,0,2717,0,2,8229,0.243
2010,34,Orleans,Urban,Commercial,6,7423,0.808,0,849,0,0,1244,0,0,2093,0,6,9516,0.631,0,3572,0,0,51,0,0,3623,0,6,13139,0.457
2010,34,Orleans,Urban,Medicaid,3,3014,0.995,3,297,10.101,0,458,0,3,755,3.974,6,3769,1.592,0,434,0,0,18,0,0,452,0,6,4221,1.421
2010,34,Orleans,Urban,Medicare,0,1653,0,1,1303,0.767,0,639,0,1,1942,0.515,1,3595,0.278,0,1682,0,0,32,0,0,1714,0,1,5309,0.188
2010,34,Orleans,Urban,Other,1,665,1.504,0,110,0,0,64,0,0,174,0,1,839,1.192,0,198,0,0,14,0,0,212,0,1,1051,0.951
2010,35,Oswego,Urban,Commercial,8,10544,0.759,5,1796,2.784,2,2662,0.751,7,4458,1.57,15,15002,1,0,8012,0,0,605,0,0,8617,0,15,23619,0.635
2010,35,Oswego,Urban,Medicaid,6,8267,0.726,8,1614,4.957,0,2180,0,8,3794,2.109,14,12061,1.161,0,1813,0,0,62,0,0,1875,0,14,13936,1.005
2011,35,Oswego,Urban,Medicaid,9,10284,0.875,13,1627,7.99,0,2124,0,13,3751,3.466,22,14035,1.568,0,2071,0,0,3718,0,0,5789,0,22,19824,1.11
2010,35,Oswego,Urban,Medicare,2,4113,0.486,12,4368,2.747,0,1785,0,12,6153,1.95,14,10266,1.364,0,4207,0,0,263,0,0,4470,0,14,14736,0.95
2010,35,Oswego,Urban,Other,0,948,0,0,159,0,0,131,0,0,290,0,0,1238,0,0,266,0,0,13,0,0,279,0,0,1517,0
2012,35,Oswego,Urban,Other,0,1080,0,1,166,6.024,0,149,0,1,315,3.175,1,1395,0.717,0,244,0,0,815,0,0,1059,0,1,2454,0.407
2013,35,Oswego,Urban,Other,2,1008,1.984,0,129,0,0,102,0,0,231,0,2,1239,1.614,0,292,0,0,871,0,0,1163,0,2,2402,0.833
2010,36,Otsego,Rural,Commercial,2,7917,0.253,3,835,3.593,2,1235,1.619,5,2070,2.415,7,9987,0.701,1,9380,0.107,0,71,0,1,9451,0.106,8,19438,0.412
2010,36,Otsego,Rural,Medicaid,3,4449,0.674,5,419,11.933,3,680,4.412,8,1099,7.279,11,5548,1.983,0,1999,0,0,30,0,0,2029,0,11,7577,1.452
2011,36,Otsego,Rural,Medicaid,2,5638,0.355,1,406,2.463,0,592,0,1,998,1.002,3,6636,0.452,0,1472,0,0,27066,0,0,28538,0,3,35174,0.085
2010,36,Otsego,Rural,Medicare,4,3315,1.207,6,2138,2.806,5,1129,4.429,11,3267,3.367,15,6582,2.279,0,8631,0,0,88,0,0,8719,0,15,15301,0.98
2010,36,Otsego,Rural,Other,0,300,0,6,506,11.858,0,275,0,6,781,7.682,6,1081,5.55,0,202,0,0,0,0,0,202,0,6,1283,4.677
2011,36,Otsego,Rural,Other,0,294,0,5,356,14.045,0,263,0,5,619,8.078,5,913,5.476,0,146,0,0,1484,0,0,1630,0,5,2543,1.966
2012,36,Otsego,Rural,Other,0,382,0,0,138,0,0,98,0,0,236,0,0,618,0,0,84,0,0,532,0,0,616,0,0,1234,0
2013,36,Otsego,Rural,Other,0,629,0,0,63,0,0,55,0,0,118,0,0,747,0,0,108,0,0,1420,0,0,1528,0,0,2275,0
2010,37,Putnam,Urban,Commercial,7,13545,0.517,7,1723,4.063,1,2531,0.395,8,4254,1.881,15,17799,0.843,0,5402,0,0,1,0,0,5403,0,15,23202,0.646
2010,37,Putnam,Urban,Medicaid,2,1863,1.074,3,340,8.824,0,527,0,3,867,3.46,5,2730,1.832,0,280,0,0,0,0,0,280,0,5,3010,1.661
2011,37,Putnam,Urban,Medicaid,4,2634,1.519,5,366,13.661,0,523,0,5,889,5.624,9,3523,2.555,0,320,0,0,2295,0,0,2615,0,9,6138,1.466
2010,37,Putnam,Urban,Medicare,0,2808,0,5,2825,1.77,0,1129,0,5,3954,1.265,5,6762,0.739,0,2551,0,0,0,0,0,2551,0,5,9313,0.537
2010,37,Putnam,Urban,Other,0,864,0,1,142,7.042,0,60,0,1,202,4.95,1,1066,0.938,0,185,0,0,0,0,0,185,0,1,1251,0.799
2013,37,Putnam,Urban,Other,2,1039,1.925,0,99,0,0,43,0,0,142,0,2,1181,1.693,0,452,0,0,689,0,0,1141,0,2,2322,0.861
2010,38,Rensselaer,Urban,Medicaid,11,13532,0.813,4,1897,2.109,0,1971,0,4,3868,1.034,15,17400,0.862,0,1748,0,0,0,0,0,1748,0,15,19148,0.783
2010,38,Rensselaer,Urban,Medicare,4,6585,0.607,7,6186,1.132,0,1765,0,7,7951,0.88,11,14536,0.757,0,4380,0,0,13,0,0,4393,0,11,18929,0.581
2012,38,Rensselaer,Urban,Medicare,2,8974,0.223,3,5770,0.52,0,1756,0,3,7526,0.399,5,16500,0.303,0,6345,0,0,7769,0,0,14114,0,5,30614,0.163
2013,38,Rensselaer,Urban,Medicare,3,5558,0.54,6,4803,1.249,2,1651,1.211,8,6454,1.24,11,12012,0.916,0,7164,0,0,11322,0,0,18486,0,11,30498,0.361
2014,38,Rensselaer,Urban,Other,0,931,0,0,87,0,0,83,0,0,170,0,0,1101,0,0,216,0,0,883,0,0,1099,0,0,2200,0
2010,39,Rockland,Urban,Commercial,3,26675,0.112,13,5274,2.465,0,7250,0,13,12524,1.038,16,39199,0.408,0,8169,0,0,8,0,0,8177,0,16,47376,0.338
2010,39,Rockland,Urban,Medicaid,6,12000,0.5,12,3331,3.603,0,5656,0,12,8987,1.335,18,20987,0.858,0,2166,0,0,3,0,0,2169,0,18,23156,0.777
2010,39,Rockland,Urban,Medicare,2,7515,0.266,5,9210,0.543,1,3778,0.265,6,12988,0.462,8,20503,0.39,0,4092,0,0,6,0,0,4098,0,8,24601,0.325
2010,39,Rockland,Urban,Other,0,1922,0,0,217,0,0,131,0,0,348,0,0,2270,0,0,133,0,0,0,0,0,133,0,0,2403,0
2012,39,Rockland,Urban,Other,0,2446,0,0,243,0,0,178,0,0,421,0,0,2867,0,0,174,0,0,1272,0,0,1446,0,0,4313,0
2013,39,Rockland,Urban,Other,2,2429,0.823,0,197,0,0,152,0,0,349,0,2,2778,0.72,0,183,0,0,1181,0,0,1364,0,2,4142,0.483
2010,40,St. Lawrence,Rural,Commercial,3,22314,0.134,2,1853,1.079,0,2276,0,2,4129,0.484,5,26443,0.189,0,7718,0,0,19,0,0,7737,0,5,34180,0.146
2010,40,St. Lawrence,Rural,Medicaid,6,15779,0.38,12,1532,7.833,0,1983,0,12,3515,3.414,18,19294,0.933,0,1770,0,0,4,0,0,1774,0,18,21068,0.854
2012,40,St. Lawrence,Rural,Medicaid,9,20742,0.434,12,1407,8.529,0,1849,0,12,3256,3.686,21,23998,0.875,0,1856,0,0,6253,0,0,8109,0,21,32107,0.654
2013,40,St. Lawrence,Rural,Medicaid,4,12439,0.322,5,1071,4.669,0,1480,0,5,2551,1.96,9,14990,0.6,0,1596,0,0,5593,0,0,7189,0,9,22179,0.406
2010,40,St. Lawrence,Rural,Medicare,1,7476,0.134,5,3921,1.275,0,1818,0,5,5739,0.871,6,13215,0.454,0,4658,0,0,9,0,0,4667,0,6,17882,0.336
2010,40,St. Lawrence,Rural,Other,0,3025,0,0,416,0,0,304,0,0,720,0,0,3745,0,0,883,0,0,0,0,0,883,0,0,4628,0
2012,40,St. Lawrence,Rural,Other,2,4532,0.441,0,448,0,0,296,0,0,744,0,2,5276,0.379,0,926,0,0,1635,0,0,2561,0,2,7837,0.255
2013,40,St. Lawrence,Rural,Other,3,6702,0.448,2,585,3.419,0,481,0,2,1066,1.876,5,7768,0.644,0,1056,0,0,2788,0,0,3844,0,5,11612,0.431
2010,41,Saratoga,Urban,Commercial,15,19329,0.776,11,3641,3.021,0,5619,0,11,9260,1.188,26,28589,0.909,0,16566,0,0,11,0,0,16577,0,26,45166,0.576
2010,41,Saratoga,Urban,Medicaid,7,6839,1.024,7,1322,5.295,1,1625,0.615,8,2947,2.715,15,9786,1.533,0,1653,0,0,0,0,0,1653,0,15,11439,1.311
2012,41,Saratoga,Urban,Medicaid,8,10857,0.737,9,1287,6.993,2,1552,1.289,11,2839,3.875,19,13696,1.387,0,2288,0,0,3187,0,0,5475,0,19,19171,0.991
2013,41,Saratoga,Urban,Medicaid,10,9572,1.045,7,1248,5.609,4,1569,2.549,11,2817,3.905,21,12389,1.695,0,2607,0,0,4427,0,0,7034,0,21,19423,1.081
2010,41,Saratoga,Urban,Medicare,3,6641,0.452,6,6634,0.904,0,2657,0,6,9291,0.646,9,15932,0.565,0,7510,0,0,8,0,0,7518,0,9,23450,0.384
2010,41,Saratoga,Urban,Other,0,1613,0,0,241,0,0,387,0,0,628,0,0,2241,0,0,641,0,0,0,0,0,641,0,0,2882,0
2011,41,Saratoga,Urban,Other,2,2120,0.943,1,274,3.65,1,392,2.551,2,666,3.003,4,2786,1.436,0,714,0,0,1137,0,0,1851,0,4,4637,0.863
2012,41,Saratoga,Urban,Other,1,2208,0.453,1,247,4.049,0,455,0,1,702,1.425,2,2910,0.687,0,737,0,0,1033,0,0,1770,0,2,4680,0.427
2013,41,Saratoga,Urban,Other,2,2131,0.939,0,215,0,0,404,0,0,619,0,2,2750,0.727,0,673,0,0,1470,0,0,2143,0,2,4893,0.409
2010,42,Schenectady,Urban,Commercial,13,30048,0.433,6,2703,2.22,2,4324,0.463,8,7027,1.138,21,37075,0.566,0,13332,0,0,12,0,0,13344,0,21,50419,0.417
2010,42,Schenectady,Urban,Medicaid,8,20123,0.398,7,2082,3.362,2,2559,0.782,9,4641,1.939,17,24764,0.686,0,2247,0,0,2,0,0,2249,0,17,27013,0.629
2010,42,Schenectady,Urban,Medicare,10,10778,0.928,5,5220,0.958,2,2703,0.74,7,7923,0.884,17,18701,0.909,1,6908,0.145,0,21,0,1,6929,0.144,18,25630,0.702
2010,42,Schenectady,Urban,Other,0,629,0,1,79,12.658,0,136,0,1,215,4.651,1,844,1.185,0,355,0,0,3,0,0,358,0,1,1202,0.832
2010,43,Schoharie,Urban,Commercial,4,5457,0.733,0,428,0,2,630,3.175,2,1058,1.89,6,6515,0.921,0,4200,0,0,3,0,0,4203,0,6,10718,0.56
2010,43,Schoharie,Urban,Medicaid,4,3044,1.314,0,190,0,1,431,2.32,1,621,1.61,5,3665,1.364,0,1075,0,0,2,0,0,1077,0,5,4742,1.054
2010,43,Schoharie,Urban,Medicare,0,2576,0,2,779,2.567,2,637,3.14,4,1416,2.825,4,3992,1.002,0,3612,0,0,2,0,0,3614,0,4,7606,0.526
2010,43,Schoharie,Urban,Other,0,349,0,1,47,21.277,0,61,0,1,108,9.259,1,457,2.188,0,100,0,0,0,0,0,100,0,1,557,1.795
2011,43,Schoharie,Urban,Other,0,339,0,0,42,0,0,56,0,0,98,0,0,437,0,0,90,0,0,659,0,0,749,0,0,1186,0
2012,43,Schoharie,Urban,Other,0,270,0,1,37,27.027,0,44,0,1,81,12.346,1,351,2.849,0,44,0,0,330,0,0,374,0,1,725,1.379
2013,43,Schoharie,Urban,Other,0,320,0,0,24,0,0,56,0,0,80,0,0,400,0,0,56,0,0,455,0,0,511,0,0,911,0
2014,43,Schoharie,Urban,Other,0,318,0,0,38,0,0,59,0,0,97,0,0,415,0,0,63,0,0,367,0,0,430,0,0,845,0
2010,44,Schuyler,Rural,Commercial,1,3053,0.328,0,249,0,0,389,0,0,638,0,1,3691,0.271,0,956,0,0,10,0,0,966,0,1,4657,0.215
2011,44,Schuyler,Rural,Commercial,0,3594,0,0,215,0,0,338,0,0,553,0,0,4147,0,0,1082,0,0,2473,0,0,3555,0,0,7702,0
2012,44,Schuyler,Rural,Commercial,3,3548,0.846,1,266,3.759,1,470,2.128,2,736,2.717,5,4284,1.167,0,1107,0,0,2745,0,0,3852,0,5,8136,0.615
2010,44,Schuyler,Rural,Medicaid,2,1812,1.104,1,171,5.848,1,237,4.219,2,408,4.902,4,2220,1.802,0,226,0,0,6,0,0,232,0,4,2452,1.631
2011,44,Schuyler,Rural,Medicaid,2,2198,0.91,0,154,0,0,258,0,0,412,0,2,2610,0.766,0,278,0,0,985,0,0,1263,0,2,3873,0.516
2012,44,Schuyler,Rural,Medicaid,0,2096,0,1,120,8.333,0,175,0,1,295,3.39,1,2391,0.418,0,218,0,0,2470,0,0,2688,0,1,5079,0.197
2013,44,Schuyler,Rural,Medicaid,2,2203,0.908,2,103,19.417,1,147,6.803,3,250,12,5,2453,2.038,0,199,0,0,1835,0,0,2034,0,5,4487,1.114
2010,44,Schuyler,Rural,Medicare,0,1854,0,0,341,0,0,595,0,0,936,0,0,2790,0,0,753,0,0,6,0,0,759,0,0,3549,0
2011,44,Schuyler,Rural,Medicare,3,1922,1.561,1,363,2.755,1,653,1.531,2,1016,1.969,5,2938,1.702,0,860,0,0,3021,0,0,3881,0,5,6819,0.733
2012,44,Schuyler,Rural,Medicare,1,2027,0.493,0,379,0,1,670,1.493,1,1049,0.953,2,3076,0.65,0,798,0,0,4972,0,0,5770,0,2,8846,0.226
2010,44,Schuyler,Rural,Other,2,1032,1.938,1,58,17.241,0,88,0,1,146,6.849,3,1178,2.547,0,154,0,0,2,0,0,156,0,3,1334,2.249
2011,44,Schuyler,Rural,Other,0,838,0,0,68,0,0,35,0,0,103,0,0,941,0,0,186,0,0,502,0,0,688,0,0,1629,0
2013,44,Schuyler,Rural,Other,0,235,0,1,24,41.667,0,19,0,1,43,23.256,1,278,3.597,0,35,0,0,178,0,0,213,0,1,491,2.037
2014,44,Schuyler,Rural,Other,0,216,0,0,18,0,0,24,0,0,42,0,0,258,0,0,54,0,0,297,0,0,351,0,0,609,0
2011,45,Seneca,Rural,Commercial,3,4958,0.605,1,403,2.481,0,726,0,1,1129,0.886,4,6087,0.657,0,2714,0,0,4113,0,0,6827,0,4,12914,0.31
2012,45,Seneca,Rural,Commercial,5,4960,1.008,4,456,8.772,0,692,0,4,1148,3.484,9,6108,1.473,0,2507,0,0,3861,0,0,6368,0,9,12476,0.721
2010,45,Seneca,Rural,Medicaid,4,2415,1.656,2,204,9.804,1,346,2.89,3,550,5.455,7,2965,2.361,0,460,0,0,16,0,0,476,0,7,3441,2.034
2011,45,Seneca,Rural,Medicaid,4,2703,1.48,2,236,8.475,0,376,0,2,612,3.268,6,3315,1.81,0,531,0,0,1059,0,0,1590,0,6,4905,1.223
2012,45,Seneca,Rural,Medicaid,3,2867,1.046,1,288,3.472,1,374,2.674,2,662,3.021,5,3529,1.417,0,475,0,0,1022,0,0,1497,0,5,5026,0.995
2013,45,Seneca,Rural,Medicaid,2,2797,0.715,4,242,16.529,0,360,0,4,602,6.645,6,3399,1.765,0,528,0,2,1338,1.495,2,1866,1.072,8,5265,1.519
2010,45,Seneca,Rural,Medicare,2,1819,1.1,0,1145,0,0,510,0,0,1655,0,2,3474,0.576,0,1545,0,0,25,0,0,1570,0,2,5044,0.397
2011,45,Seneca,Rural,Medicare,1,1787,0.56,0,1134,0,0,482,0,0,1616,0,1,3403,0.294,0,1776,0,0,3645,0,0,5421,0,1,8824,0.113
2012,45,Seneca,Rural,Medicare,1,1924,0.52,1,1200,0.833,0,483,0,1,1683,0.594,2,3607,0.554,0,1661,0,0,3936,0,0,5597,0,2,9204,0.217
2013,45,Seneca,Rural,Medicare,2,2217,0.902,3,1247,2.406,0,529,0,3,1776,1.689,5,3993,1.252,0,1644,0,0,4014,0,0,5658,0,5,9651,0.518
2010,45,Seneca,Rural,Other,1,388,2.577,1,77,12.987,0,44,0,1,121,8.264,2,509,3.929,0,187,0,0,5,0,0,192,0,2,701,2.853
2011,45,Seneca,Rural,Other,0,366,0,0,48,0,0,47,0,0,95,0,0,461,0,0,137,0,0,444,0,0,581,0,0,1042,0
2012,45,Seneca,Rural,Other,0,376,0,1,58,17.241,0,33,0,1,91,10.989,1,467,2.141,0,136,0,0,460,0,0,596,0,1,1063,0.941
2012,46,Steuben,Rural,Medicaid,6,12102,0.496,7,960,7.292,1,1472,0.679,8,2432,3.289,14,14534,0.963,0,1519,0,0,5268,0,0,6787,0,14,21321,0.657
2010,46,Steuben,Rural,Medicare,1,5200,0.192,9,3638,2.474,1,1603,0.624,10,5241,1.908,11,10441,1.054,0,3910,0,0,41,0,0,3951,0,11,14392,0.764
2010,46,Steuben,Rural,Other,1,1894,0.528,0,211,0,1,212,4.717,1,423,2.364,2,2317,0.863,0,647,0,0,14,0,0,661,0,2,2978,0.672
2012,46,Steuben,Rural,Other,0,1317,0,1,146,6.849,0,132,0,1,278,3.597,1,1595,0.627,0,268,0,0,647,0,0,915,0,1,2510,0.398
2013,46,Steuben,Rural,Other,0,1289,0,0,111,0,0,129,0,0,240,0,0,1529,0,0,290,0,0,704,0,0,994,0,0,2523,0
2010,48,Sullivan,Rural,Commercial,2,6936,0.288,8,991,8.073,0,1602,0,8,2593,3.085,10,9529,1.049,0,3497,0,0,8,0,0,3505,0,10,13034,0.767
2010,48,Sullivan,Rural,Medicaid,8,7996,1.001,5,972,5.144,0,1066,0,5,2038,2.453,13,10034,1.296,0,1071,0,0,1,0,0,1072,0,13,11106,1.171
2010,48,Sullivan,Rural,Medicare,1,3978,0.251,1,1955,0.512,0,1330,0,1,3285,0.304,2,7263,0.275,0,2106,0,0,3,0,0,2109,0,2,9372,0.213
2010,48,Sullivan,Rural,Other,1,3496,0.286,3,295,10.169,0,103,0,3,398,7.538,4,3894,1.027,0,317,0,0,0,0,0,317,0,4,4211,0.95
2013,48,Sullivan,Rural,Other,0,1139,0,1,128,7.813,0,83,0,1,211,4.739,1,1350,0.741,0,302,0,0,487,0,0,789,0,1,2139,0.468
2010,49,Tioga,Urban,Commercial,2,3061,0.653,1,420,2.381,0,730,0,1,1150,0.87,3,4211,0.712,0,1729,0,0,12,0,0,1741,0,3,5952,0.504
2010,49,Tioga,Urban,Medicaid,2,1338,1.495,1,242,4.132,1,381,2.625,2,623,3.21,4,1961,2.04,0,239,0,0,13,0,0,252,0,4,2213,1.808
2012,49,Tioga,Urban,Medicaid,2,1843,1.085,1,231,4.329,0,384,0,1,615,1.626,3,2458,1.221,0,285,0,0,6148,0,0,6433,0,3,8891,0.337
2013,49,Tioga,Urban,Medicaid,2,1671,1.197,1,202,4.95,0,344,0,1,546,1.832,3,2217,1.353,0,295,0,0,3912,0,0,4207,0,3,6424,0.467
2010,49,Tioga,Urban,Medicare,2,1012,1.976,0,631,0,0,276,0,0,907,0,2,1919,1.042,0,831,0,0,4,0,0,835,0,2,2754,0.726
2013,49,Tioga,Urban,Medicare,3,1257,2.387,0,744,0,0,338,0,0,1082,0,3,2339,1.283,0,855,0,0,12350,0,0,13205,0,3,15544,0.193
2010,49,Tioga,Urban,Other,0,145,0,0,34,0,0,24,0,0,58,0,0,203,0,0,27,0,0,0,0,0,27,0,0,230,0
2012,49,Tioga,Urban,Other,0,399,0,1,44,22.727,0,15,0,1,59,16.949,1,458,2.183,0,67,0,0,176,0,0,243,0,1,701,1.427
2013,49,Tioga,Urban,Other,0,235,0,1,34,29.412,0,33,0,1,67,14.925,1,302,3.311,0,47,0,0,249,0,0,296,0,1,598,1.672
2010,50,Tompkins,Urban,Commercial,1,6362,0.157,1,1035,0.966,0,1862,0,1,2897,0.345,2,9259,0.216,0,3548,0,0,24,0,0,3572,0,2,12831,0.156
2010,50,Tompkins,Urban,Medicaid,1,3997,0.25,4,468,8.547,0,666,0,4,1134,3.527,5,5131,0.974,0,529,0,0,13,0,0,542,0,5,5673,0.881
2011,50,Tompkins,Urban,Medicaid,2,6370,0.314,5,602,8.306,0,864,0,5,1466,3.411,7,7836,0.893,0,845,0,0,2186,0,0,3031,0,7,10867,0.644
2010,50,Tompkins,Urban,Medicare,0,2552,0,3,1877,1.598,0,779,0,3,2656,1.13,3,5208,0.576,0,1677,0,0,7,0,0,1684,0,3,6892,0.435
2010,50,Tompkins,Urban,Other,0,472,0,1,214,4.673,0,234,0,1,448,2.232,1,920,1.087,0,59,0,0,0,0,0,59,0,1,979,1.021
2011,50,Tompkins,Urban,Other,0,1202,0,0,65,0,0,30,0,0,95,0,0,1297,0,0,85,0,0,269,0,0,354,0,0,1651,0
2013,50,Tompkins,Urban,Other,1,655,1.527,0,49,0,0,42,0,0,91,0,1,746,1.34,0,95,0,0,536,0,0,631,0,1,1377,0.726
2010,51,Ulster,Urban,Commercial,17,21407,0.794,11,2947,3.733,2,5134,0.39,13,8081,1.609,30,29488,1.017,0,9942,0,0,8,0,0,9950,0,30,39438,0.761
2010,51,Ulster,Urban,Medicaid,7,12412,0.564,3,1380,2.174,2,2600,0.769,5,3980,1.256,12,16392,0.732,0,1462,0,0,1,0,0,1463,0,12,17855,0.672
2010,51,Ulster,Urban,Medicare,6,7999,0.75,7,5700,1.228,0,4557,0,7,10257,0.682,13,18256,0.712,0,5878,0,0,8,0,0,5886,0,13,24142,0.538
2010,51,Ulster,Urban,Other,0,1882,0,1,253,3.953,0,251,0,1,504,1.984,1,2386,0.419,0,830,0,0,1,0,0,831,0,1,3217,0.311
2011,51,Ulster,Urban,Other,1,2116,0.473,2,312,6.41,0,196,0,2,508,3.937,3,2624,1.143,0,986,0,0,1062,0,0,2048,0,3,4672,0.642
2012,51,Ulster,Urban,Other,3,2641,1.136,0,323,0,0,155,0,0,478,0,3,3119,0.962,0,1036,0,0,994,0,0,2030,0,3,5149,0.583
2013,51,Ulster,Urban,Other,2,2718,0.736,1,339,2.95,0,147,0,1,486,2.058,3,3204,0.936,0,966,0,0,995,0,0,1961,0,3,5165,0.581
2010,52,Warren,Urban,Commercial,5,6590,0.759,6,1536,3.906,1,1571,0.637,7,3107,2.253,12,9697,1.237,0,3572,0,0,1,0,0,3573,0,12,13270,0.904
2012,52,Warren,Urban,Commercial,3,8790,0.341,5,1149,4.352,0,1316,0,5,2465,2.028,8,11255,0.711,0,4674,0,0,6693,0,0,11367,0,8,22622,0.354
2010,52,Warren,Urban,Medicaid,1,3273,0.306,7,837,8.363,0,842,0,7,1679,4.169,8,4952,1.616,0,728,0,0,0,0,0,728,0,8,5680,1.408
2011,52,Warren,Urban,Medicaid,4,4802,0.833,3,753,3.984,0,841,0,3,1594,1.882,7,6396,1.094,0,1113,0,0,3516,0,0,4629,0,7,11025,0.635
2012,52,Warren,Urban,Medicaid,3,4988,0.601,4,596,6.711,0,812,0,4,1408,2.841,7,6396,1.094,0,992,0,0,2956,0,0,3948,0,7,10344,0.677
2013,52,Warren,Urban,Medicaid,5,4795,1.043,3,628,4.777,0,773,0,3,1401,2.141,8,6196,1.291,0,1053,0,0,3407,0,0,4460,0,8,10656,0.751
2010,52,Warren,Urban,Medicare,1,2745,0.364,9,3002,2.998,0,1123,0,9,4125,2.182,10,6870,1.456,0,2997,0,0,1,0,0,2998,0,10,9868,1.013
2011,52,Warren,Urban,Medicare,1,4154,0.241,5,3205,1.56,0,1059,0,5,4264,1.173,6,8418,0.713,0,3916,0,0,9982,0,0,13898,0,6,22316,0.269
2012,52,Warren,Urban,Medicare,1,4897,0.204,8,3042,2.63,0,976,0,8,4018,1.991,9,8915,1.01,0,4041,0,0,10183,0,0,14224,0,9,23139,0.389
2013,52,Warren,Urban,Medicare,6,5022,1.195,7,2994,2.338,0,980,0,7,3974,1.761,13,8996,1.445,0,4229,0,0,10757,0,0,14986,0,13,23982,0.542
2010,52,Warren,Urban,Other,1,563,1.776,1,77,12.987,0,51,0,1,128,7.813,2,691,2.894,0,114,0,0,0,0,0,114,0,2,805,2.484
2011,52,Warren,Urban,Other,0,723,0,0,93,0,0,46,0,0,139,0,0,862,0,0,165,0,0,213,0,0,378,0,0,1240,0
2012,52,Warren,Urban,Other,0,731,0,0,92,0,0,54,0,0,146,0,0,877,0,0,154,0,0,253,0,0,407,0,0,1284,0
2013,52,Warren,Urban,Other,1,730,1.37,0,89,0,0,47,0,0,136,0,1,866,1.155,0,133,0,0,237,0,0,370,0,1,1236,0.809
2010,53,Washington,Urban,Commercial,2,5500,0.364,4,1311,3.051,0,1336,0,4,2647,1.511,6,8147,0.736,0,3156,0,0,2,0,0,3158,0,6,11305,0.531
2010,53,Washington,Urban,Medicaid,3,2967,1.011,5,631,7.924,0,860,0,5,1491,3.353,8,4458,1.795,0,801,0,0,1,0,0,802,0,8,5260,1.521
2011,53,Washington,Urban,Medicaid,6,4557,1.317,6,685,8.759,0,786,0,6,1471,4.079,12,6028,1.991,0,1121,0,0,2893,0,0,4014,0,12,10042,1.195
2013,53,Washington,Urban,Medicaid,2,4637,0.431,1,594,1.684,0,774,0,1,1368,0.731,3,6005,0.5,0,1241,0,0,2709,0,0,3950,0,3,9955,0.301
2010,53,Washington,Urban,Medicare,0,1923,0,7,2568,2.726,0,820,0,7,3388,2.066,7,5311,1.318,0,2273,0,0,0,0,0,2273,0,7,7584,0.923
2012,53,Washington,Urban,Medicare,0,3730,0,6,2632,2.28,0,825,0,6,3457,1.736,6,7187,0.835,0,3386,0,0,7174,0,0,10560,0,6,17747,0.338
2013,53,Washington,Urban,Medicare,4,3775,1.06,6,2487,2.413,0,748,0,6,3235,1.855,10,7010,1.427,0,3307,0,0,7498,0,0,10805,0,10,17815,0.561
2010,53,Washington,Urban,Other,0,574,0,0,111,0,0,88,0,0,199,0,0,773,0,0,225,0,0,0,0,0,225,0,0,998,0
2011,53,Washington,Urban,Other,0,748,0,2,170,11.765,0,72,0,2,242,8.264,2,990,2.02,0,296,0,0,281,0,0,577,0,2,1567,1.276
2012,53,Washington,Urban,Other,1,882,1.134,0,160,0,0,88,0,0,248,0,1,1130,0.885,0,310,0,0,236,0,0,546,0,1,1676,0.597
2013,53,Washington,Urban,Other,0,886,0,0,170,0,0,71,0,0,241,0,0,1127,0,0,274,0,0,407,0,0,681,0,0,1808,0
2014,53,Washington,Urban,Other,1,828,1.208,0,183,0,0,83,0,0,266,0,1,1094,0.914,0,279,0,0,345,0,0,624,0,1,1718,0.582
2010,54,Wayne,Urban,Medicaid,2,6525,0.307,2,650,3.077,1,975,1.026,3,1625,1.846,5,8150,0.613,0,1166,0,0,125,0,0,1291,0,5,9441,0.53
2010,54,Wayne,Urban,Medicare,0,4784,0,7,3712,1.886,2,1409,1.419,9,5121,1.757,9,9905,0.909,0,3083,0,0,70,0,0,3153,0,9,13058,0.689
2010,54,Wayne,Urban,Other,0,717,0,0,109,0,0,62,0,0,171,0,0,888,0,0,227,0,0,47,0,0,274,0,0,1162,0
2012,54,Wayne,Urban,Other,0,835,0,1,136,7.353,0,75,0,1,211,4.739,1,1046,0.956,0,211,0,0,646,0,0,857,0,1,1903,0.525
2013,54,Wayne,Urban,Other,0,851,0,0,140,0,0,114,0,0,254,0,0,1105,0,0,414,0,0,470,0,0,884,0,0,1989,0
2010,55,Westchester,Urban,Medicaid,14,53510,0.262,27,10415,2.592,1,12012,0.083,28,22427,1.248,42,75937,0.553,0,5866,0,0,14,0,0,5880,0,42,81817,0.513
2010,56,Wyoming,Rural,Commercial,7,7481,0.936,1,704,1.42,3,1321,2.271,4,2025,1.975,11,9506,1.157,0,3588,0,0,37,0,0,3625,0,11,13131,0.838
2010,56,Wyoming,Rural,Medicaid,0,1417,0,1,195,5.128,0,430,0,1,625,1.6,1,2042,0.49,0,324,0,0,20,0,0,344,0,1,2386,0.419
2011,56,Wyoming,Rural,Medicaid,2,1630,1.227,4,239,16.736,0,440,0,4,679,5.891,6,2309,2.599,0,368,0,0,1425,0,0,1793,0,6,4102,1.463
2010,56,Wyoming,Rural,Medicare,1,1962,0.51,1,1097,0.912,0,793,0,1,1890,0.529,2,3852,0.519,0,1811,0,0,26,0,0,1837,0,2,5689,0.352
2010,56,Wyoming,Rural,Other,0,544,0,0,133,0,0,56,0,0,189,0,0,733,0,0,381,0,0,9,0,0,390,0,0,1123,0
2011,56,Wyoming,Rural,Other,0,628,0,0,85,0,0,65,0,0,150,0,0,778,0,0,318,0,0,462,0,0,780,0,0,1558,0
2010,57,Yates,Urban,Commercial,3,3953,0.759,1,270,3.704,0,587,0,1,857,1.167,4,4810,0.832,0,1799,0,0,18,0,0,1817,0,4,6627,0.604
2011,57,Yates,Urban,Commercial,1,3955,0.253,0,271,0,1,629,1.59,1,900,1.111,2,4855,0.412,0,1978,0,0,3438,0,0,5416,0,2,10271,0.195
2012,57,Yates,Urban,Commercial,1,3508,0.285,1,257,3.891,0,501,0,1,758,1.319,2,4266,0.469,0,1761,0,0,3218,0,0,4979,0,2,9245,0.216
2010,57,Yates,Urban,Medicaid,2,2745,0.729,1,111,9.009,0,332,0,1,443,2.257,3,3188,0.941,0,440,0,0,11,0,0,451,0,3,3639,0.824
2011,57,Yates,Urban,Medicaid,0,2963,0,2,124,16.129,1,318,3.145,3,442,6.787,3,3405,0.881,0,441,0,0,899,0,0,1340,0,3,4745,0.632
2012,57,Yates,Urban,Medicaid,2,2802,0.714,0,118,0,1,272,3.676,1,390,2.564,3,3192,0.94,0,371,0,0,997,0,0,1368,0,3,4560,0.658
2010,57,Yates,Urban,Medicare,1,2047,0.489,1,688,1.453,0,540,0,1,1228,0.814,2,3275,0.611,0,1466,0,0,12,0,0,1478,0,2,4753,0.421
2012,57,Yates,Urban,Medicare,1,2131,0.469,3,740,4.054,0,520,0,3,1260,2.381,4,3391,1.18,0,1308,0,0,3654,0,0,4962,0,4,8353,0.479
2013,57,Yates,Urban,Medicare,0,2297,0,0,587,0,1,489,2.045,1,1076,0.929,1,3373,0.296,0,1359,0,0,3886,0,0,5245,0,1,8618,0.116
2010,57,Yates,Urban,Other,0,361,0,1,37,27.027,0,18,0,1,55,18.182,1,416,2.404,0,85,0,0,3,0,0,88,0,1,504,1.984
2011,57,Yates,Urban,Other,0,436,0,0,28,0,0,25,0,0,53,0,0,489,0,0,65,0,0,184,0,0,249,0,0,738,0
2012,57,Yates,Urban,Other,0,400,0,0,36,0,0,12,0,0,48,0,0,448,0,0,72,0,0,164,0,0,236,0,0,684,0
2013,57,Yates,Urban,Other,0,402,0,0,31,0,0,42,0,0,73,0,0,475,0,0,129,0,0,193,0,0,322,0,0,797,0
2014,57,Yates,Urban,Other,0,397,0,0,35,0,0,57,0,0,92,0,0,489,0,0,128,0,0,227,0,0,355,0,0,844,0
2010,58,Bronx,Urban,Other,1,9453,0.106,3,1564,1.918,0,685,0,3,2249,1.334,4,11702,0.342,0,2701,0,0,7,0,0,2708,0,4,14410,0.278
2010,59,Kings (Brooklyn),Urban,Other,1,13555,0.074,4,2509,1.594,1,1166,0.858,5,3675,1.361,6,17230,0.348,0,3214,0,0,18,0,0,3232,0,6,20462,0.293
2010,60,New York (Manhattan),Urban,Medicare,11,48562,0.227,71,43664,1.626,7,21622,0.324,78,65286,1.195,89,113848,0.782,0,44431,0,0,111,0,0,44542,0,89,158390,0.562
2010,60,New York (Manhattan),Urban,Other,2,6205,0.322,1,1160,0.862,0,769,0,1,1929,0.518,3,8134,0.369,0,1330,0,0,7,0,0,1337,0,3,9471,0.317
2012,13,Dutchess,Urban,Unknown,0,6,0,0,1,0,0,6,0,0,7,0,0,13,0,0,113,0,0,4,0,0,117,0,0,130,0
2011,42,Schenectady,Urban,Unknown,0,8,0,0,0,0,0,0,0,0,0,0,0,8,0,0,0,0,0,1,0,0,1,0,0,9,0
2011,47,Suffolk,Urban,Unknown,1,871,1.148,1,388,2.577,0,213,0,1,601,1.664,2,1472,1.359,0,5906,0,0,444,0,0,6350,0,2,7822,0.256
2014,59,Kings (Brooklyn),Urban,Unknown,4,7710,0.519,3,606,4.95,12,1366,8.785,15,1972,7.606,19,9682,1.962,0,653,0,0,2265,0,0,2918,0,19,12600,1.508
2015,26,Monroe,Urban,Unknown,0,28,0,0,3,0,0,1,0,0,4,0,0,32,0,0,147,0,0,2,0,0,149,0,0,181,0
2014,10,Columbia,Rural,Unknown,0,1,0,0,0,0,0,0,0,0,0,0,0,1,0,0,2,0,0,0,0,0,2,0,0,3,0
2014,12,Delaware,Rural,Unknown,0,112,0,0,1,0,0,1,0,0,2,0,0,114,0,0,1,0,0,656,0,0,657,0,0,771,0
2014,6,Chautauqua,Rural,Unknown,0,0,,0,0,,0,0,,0,0,,0,0,,0,2,0,0,1,0,0,3,0,0,3,0
2012,47,Suffolk,Urban,Unknown,0,915,0,0,349,0,0,199,0,0,548,0,0,1463,0,0,2304,0,0,330,0,0,2634,0,0,4097,0
2013,88,Other than New York State,Urban,Unknown,0,496,0,0,59,0,0,110,0,0,169,0,0,665,0,0,557,0,0,357,0,0,914,0,0,1579,0
2010,4,Cattaraugus,Rural,Unknown,0,1403,0,0,71,0,0,30,0,0,101,0,0,1504,0,0,778,0,0,0,0,0,778,0,0,2282,0
2012,36,Otsego,Rural,Unknown,0,5,0,0,1,0,0,4,0,0,5,0,0,10,0,0,8,0,0,14,0,0,22,0,0,32,0
2011,54,Wayne,Urban,Unknown,0,3,0,0,0,0,0,0,0,0,0,0,0,3,0,0,1337,0,0,0,0,0,1337,0,0,1340,0
2015,49,Tioga,Urban,Unknown,0,2,0,0,0,0,0,7,0,0,7,0,0,9,0,0,2,0,0,12,0,0,14,0,0,23,0
2010,43,Schoharie,Urban,Unknown,0,176,0,0,2,0,0,3,0,0,5,0,0,181,0,0,124,0,0,0,0,0,124,0,0,305,0
2014,22,Jefferson,Urban,Unknown,0,2,0,0,0,0,0,5,0,0,5,0,0,7,0,0,63,0,0,10,0,0,73,0,0,80,0
2012,34,Orleans,Urban,Unknown,0,0,,0,0,,0,0,,0,0,,0,0,,0,168,0,0,0,0,0,168,0,0,168,0
2012,9,Clinton,Rural,Unknown,0,1,0,0,0,0,0,0,0,0,0,0,0,1,0,0,1,0,0,0,0,0,1,0,0,2,0
2013,33,Orange,Urban,Unknown,0,19,0,0,3,0,0,5,0,0,8,0,0,27,0,0,79,0,0,3,0,0,82,0,0,109,0
2011,6,Chautauqua,Rural,Unknown,0,8,0,0,0,0,0,0,0,0,0,0,0,8,0,0,34,0,0,13,0,0,47,0,0,55,0
2011,12,Delaware,Rural,Unknown,0,732,0,0,33,0,0,8,0,0,41,0,0,773,0,0,39,0,0,1237,0,0,1276,0,0,2049,0
2011,41,Saratoga,Urban,Unknown,0,3,0,0,0,0,0,1,0,0,1,0,0,4,0,0,2,0,0,1,0,0,3,0,0,7,0
2015,38,Rensselaer,Urban,Unknown,0,11,0,0,0,0,0,0,0,0,0,0,0,11,0,0,2,0,0,2,0,0,4,0,0,15,0
2011,3,Broome,Urban,Unknown,4,1820,2.198,1,73,13.699,0,18,0,1,91,10.989,5,1911,2.616,0,48,0,0,13,0,0,61,0,5,1972,2.535
2015,99,Unknown,Urban,Unknown,0,127,0,0,22,0,0,32,0,0,54,0,0,181,0,0,430,0,0,115,0,0,545,0,0,726,0
2014,19,Greene,Rural,Unknown,0,1,0,0,0,0,0,1,0,0,1,0,0,2,0,0,0,,0,0,,0,0,,0,2,0
2013,8,Chenango,Rural,Unknown,0,12,0,0,0,0,0,3,0,0,3,0,0,15,0,0,55,0,0,15,0,0,70,0,0,85,0
2010,15,Essex,Rural,Unknown,0,1449,0,0,1,0,0,7,0,0,8,0,0,1457,0,0,581,0,0,0,0,0,581,0,0,2038,0
2012,37,Putnam,Urban,Unknown,0,5,0,0,0,0,0,2,0,0,2,0,0,7,0,0,64,0,0,8,0,0,72,0,0,79,0
2010,12,Delaware,Rural,Unknown,0,1584,0,0,87,0,0,51,0,0,138,0,0,1722,0,0,435,0,0,0,0,0,435,0,0,2157,0
2010,88,Other than New York State,Urban,Unknown,9,9218,0.976,0,764,0,0,2389,0,0,3153,0,9,12371,0.728,0,9063,0,0,1,0,0,9064,0,9,21435,0.42
2015,20,Hamilton,Rural,Unknown,0,18,0,0,6,0,0,5,0,0,11,0,0,29,0,0,8,0,0,7,0,0,15,0,0,44,0
2011,23,Lewis,Rural,Unknown,0,0,,0,0,,0,0,,0,0,,0,0,,0,1,0,0,0,0,0,1,0,0,1,0
2014,50,Tompkins,Urban,Unknown,0,4,0,0,2,0,0,4,0,0,6,0,0,10,0,0,10,0,0,15,0,0,25,0,0,35,0
2013,43,Schoharie,Urban,Unknown,0,0,,0,0,,0,0,,0,0,,0,0,,0,6,0,0,0,0,0,6,0,0,6,0
2015,41,Saratoga,Urban,Unknown,0,85,0,0,19,0,0,8,0,0,27,0,0,112,0,0,63,0,0,245,0,0,308,0,0,420,0
2012,55,Westchester,Urban,Unknown,0,281,0,0,7,0,0,33,0,0,40,0,0,321,0,0,391,0,0,531,0,0,922,0,0,1243,0
2010,13,Dutchess,Urban,Unknown,0,11602,0,1,209,4.785,0,318,0,1,527,1.898,1,12129,0.082,1,3456,0.289,0,0,0,1,3456,0.289,2,15585,0.128
2010,62,Richmond (Staten Island),Urban,Commercial,24,77704,0.309,56,15839,3.536,3,12774,0.235,59,28613,2.062,83,106317,0.781,1,21530,0.046,1,1468,0.681,2,22998,0.087,85,129315,0.657
2010,62,Richmond (Staten Island),Urban,Medicaid,18,35008,0.514,65,9765,6.656,0,5829,0,65,15594,4.168,83,50602,1.64,0,6308,0,0,1504,0,0,7812,0,83,58414,1.421
2010,62,Richmond (Staten Island),Urban,Medicare,7,14267,0.491,35,15881,2.204,1,4858,0.206,36,20739,1.736,43,35006,1.228,0,8914,0,0,84,0,0,8998,0,43,44004,0.977
2010,62,Richmond (Staten Island),Urban,Other,1,9999,0.1,2,930,2.151,0,351,0,2,1281,1.561,3,11280,0.266,0,968,0,0,277,0,0,1245,0,3,12525,0.24
2010,88,Other than New York State,Urban,Other,0,5582,0,1,653,1.531,0,654,0,1,1307,0.765,1,6889,0.145,0,720,0,0,5,0,0,725,0,1,7614,0.131
2010,99,Unknown,Urban,Medicaid,14,35572,0.394,25,4603,5.431,3,4794,0.626,28,9397,2.98,42,44969,0.934,0,9859,0,0,75,0,0,9934,0,42,54903,0.765
2010,99,Unknown,Urban,Medicare,7,20724,0.338,17,12927,1.315,3,6596,0.455,20,19523,1.024,27,40247,0.671,0,39474,0,0,206,0,0,39680,0,27,79927,0.338
2010,99,Unknown,Urban,Other,0,5637,0,0,467,0,0,296,0,0,763,0,0,6400,0,0,4524,0,0,30,0,0,4554,0,0,10954,0
2011,6,Chautauqua,Rural,Medicare,6,11008,0.545,5,4061,1.231,0,1453,0,5,5514,0.907,11,16522,0.666,0,5898,0,0,34685,0,0,40583,0,11,57105,0.193
2011,21,Herkimer,Urban,Commercial,2,7829,0.255,3,831,3.61,0,1244,0,3,2075,1.446,5,9904,0.505,0,5894,0,0,19879,0,0,25773,0,5,35677,0.14
2013,37,Putnam,Urban,Medicare,2,4421,0.452,9,2735,3.291,0,1059,0,9,3794,2.372,11,8215,1.339,0,3104,0,0,5824,0,0,8928,0,11,17143,0.642
2012,54,Wayne,Urban,Medicaid,2,7785,0.257,7,753,9.296,2,888,2.252,9,1641,5.484,11,9426,1.167,0,1343,0,0,3021,0,0,4364,0,11,13790,0.798
2013,36,Otsego,Rural,Medicaid,3,4667,0.643,1,434,2.304,0,593,0,1,1027,0.974,4,5694,0.702,0,811,0,0,27630,0,0,28441,0,4,34135,0.117
2015,42,Schenectady,Urban,Commercial,30,20974,1.43,4,902,4.435,4,4623,0.865,8,5525,1.448,38,26499,1.434,0,12297,0,0,32441,0,0,44738,0,38,71237,0.533
2014,15,Essex,Rural,Medicaid,4,4586,0.872,1,229,4.367,0,247,0,1,476,2.101,5,5062,0.988,0,420,0,0,2738,0,0,3158,0,5,8220,0.608
2011,46,Steuben,Rural,Commercial,6,18720,0.321,4,1561,2.562,0,2350,0,4,3911,1.023,10,22631,0.442,0,7031,0,0,12290,0,0,19321,0,10,41952,0.238
2015,4,Cattaraugus,Rural,Medicare,1,1742,0.574,2,970,2.062,1,802,1.247,3,1772,1.693,4,3514,1.138,0,1599,0,0,4560,0,0,6159,0,4,9673,0.414
2015,11,Cortland,Rural,Medicare,4,4077,0.981,2,1652,1.211,3,620,4.839,5,2272,2.201,9,6349,1.418,0,2303,0,0,4688,0,0,6991,0,9,13340,0.675
2013,54,Wayne,Urban,Commercial,4,14017,0.285,1,1727,0.579,1,2415,0.414,2,4142,0.483,6,18159,0.33,0,7236,0,0,12294,0,0,19530,0,6,37689,0.159
2014,56,Wyoming,Rural,Commercial,5,4788,1.044,2,488,4.098,0,989,0,2,1477,1.354,7,6265,1.117,0,3007,0,0,5647,0,0,8654,0,7,14919,0.469
2014,33,Orange,Urban,Medicare,19,18659,1.018,30,12280,2.443,2,4141,0.483,32,16421,1.949,51,35080,1.454,0,11394,0,0,22861,0,0,34255,0,51,69335,0.736
2014,29,Niagara,Urban,Commercial,31,32944,0.941,17,4896,3.472,0,5614,0,17,10510,1.618,48,43454,1.105,0,21432,0,0,62750,0,0,84182,0,48,127636,0.376
2014,44,Schuyler,Rural,Medicaid,1,2529,0.395,1,152,6.579,0,223,0,1,375,2.667,2,2904,0.689,0,315,0,0,4089,0,0,4404,0,2,7308,0.274
2015,37,Putnam,Urban,Medicare,6,4404,1.362,3,2750,1.091,2,1020,1.961,5,3770,1.326,11,8174,1.346,0,3197,0,0,5935,0,0,9132,0,11,17306,0.636
2014,13,Dutchess,Urban,Medicaid,48,16329,2.94,13,2090,6.22,2,2456,0.814,15,4546,3.3,63,20875,3.018,0,2355,0,0,8427,0,0,10782,0,63,31657,1.99
2012,22,Jefferson,Urban,Other,8,19853,0.403,2,1169,1.711,0,2966,0,2,4135,0.484,10,23988,0.417,0,3379,0,0,5522,0,0,8901,0,10,32889,0.304
2013,30,Oneida,Urban,Medicare,12,16860,0.712,20,10252,1.951,1,3763,0.266,21,14015,1.498,33,30875,1.069,0,11838,0,1,24953,0.04,1,36791,0.027,34,67666,0.502
2013,88,Other than New York State,Urban,Medicare,3,14827,0.202,13,8348,1.557,3,10448,0.287,16,18796,0.851,19,33623,0.565,0,15306,0,0,35506,0,0,50812,0,19,84435,0.225
2011,54,Wayne,Urban,Medicare,3,5453,0.55,5,3852,1.298,0,1418,0,5,5270,0.949,8,10723,0.746,0,3879,0,0,10953,0,0,14832,0,8,25555,0.313
2011,34,Orleans,Urban,Medicaid,0,3641,0,1,391,2.558,0,481,0,1,872,1.147,1,4513,0.222,0,493,0,0,1285,0,0,1778,0,1,6291,0.159
2015,43,Schoharie,Urban,Commercial,2,4780,0.418,0,283,0,0,595,0,0,878,0,2,5658,0.353,0,2022,0,0,7105,0,0,9127,0,2,14785,0.135
2011,16,Franklin,Rural,Other,0,1479,0,1,208,4.808,0,86,0,1,294,3.401,1,1773,0.564,0,340,0,0,478,0,0,818,0,1,2591,0.386
2013,40,St. Lawrence,Rural,Commercial,10,28728,0.348,10,1934,5.171,1,2670,0.375,11,4604,2.389,21,33332,0.63,0,8254,0,0,17214,0,0,25468,0,21,58800,0.357
2012,48,Sullivan,Rural,Medicaid,4,7970,0.502,10,958,10.438,0,1238,0,10,2196,4.554,14,10166,1.377,0,1364,0,0,3592,0,0,4956,0,14,15122,0.926
2011,57,Yates,Urban,Medicare,2,2084,0.96,1,698,1.433,0,507,0,1,1205,0.83,3,3289,0.912,0,1467,0,0,3734,0,0,5201,0,3,8490,0.353
2014,60,New York (Manhattan),Urban,Other,2,7416,0.27,1,1192,0.839,0,622,0,1,1814,0.551,3,9230,0.325,0,4002,0,0,10562,0,0,14564,0,3,23794,0.126
2015,49,Tioga,Urban,Other,0,152,0,0,15,0,0,18,0,0,33,0,0,185,0,0,37,0,0,201,0,0,238,0,0,423,0
2015,45,Seneca,Rural,Other,0,477,0,0,75,0,0,53,0,0,128,0,0,605,0,0,212,0,0,445,0,0,657,0,0,1262,0
2015,45,Seneca,Rural,Commercial,2,4837,0.413,3,429,6.993,0,662,0,3,1091,2.75,5,5928,0.843,0,2649,0,0,4078,0,0,6727,0,5,12655,0.395
2012,39,Rockland,Urban,Medicare,3,11899,0.252,7,9818,0.713,2,4546,0.44,9,14364,0.627,12,26263,0.457,0,4330,0,0,27267,0,0,31597,0,12,57860,0.207
2013,48,Sullivan,Rural,Commercial,23,19482,1.181,7,1506,4.648,0,2017,0,7,3523,1.987,30,23005,1.304,0,5417,0,0,8788,0,0,14205,0,30,37210,0.806
2015,14,Erie,Urban,Commercial,386,100646,3.835,69,10698,6.45,23,20705,1.111,92,31403,2.93,478,132049,3.62,0,81801,0,0,143701,0,0,225502,0,478,357551,1.337
2012,99,Unknown,Urban,Medicaid,31,66351,0.467,33,7161,4.608,5,6355,0.787,38,13516,2.811,69,79867,0.864,0,9758,0,1,37925,0.026,1,47683,0.021,70,127550,0.549
2014,43,Schoharie,Urban,Medicare,2,2655,0.753,2,776,2.577,0,730,0,2,1506,1.328,4,4161,0.961,0,1617,0,0,16438,0,0,18055,0,4,22216,0.18
2011,2,Allegany,Rural,Medicaid,2,7179,0.279,2,486,4.115,2,750,2.667,4,1236,3.236,6,8415,0.713,0,973,0,0,6505,0,0,7478,0,6,15893,0.378
2012,56,Wyoming,Rural,Commercial,4,5183,0.772,2,540,3.704,0,1076,0,2,1616,1.238,6,6799,0.882,0,3101,0,0,5750,0,0,8851,0,6,15650,0.383
2011,22,Jefferson,Urban,Other,1,19357,0.052,5,1060,4.717,0,2566,0,5,3626,1.379,6,22983,0.261,0,3357,0,0,5437,0,0,8794,0,6,31777,0.189
2013,5,Cayuga,Rural,Commercial,2,11174,0.179,4,998,4.008,2,1997,1.002,6,2995,2.003,8,14169,0.565,0,7013,0,3,15263,0.197,3,22276,0.135,11,36445,0.302
2013,39,Rockland,Urban,Commercial,19,35218,0.539,11,4338,2.536,4,6542,0.611,15,10880,1.379,34,46098,0.738,0,8565,0,0,26181,0,0,34746,0,34,80844,0.421
2014,38,Rensselaer,Urban,Medicaid,31,15746,1.969,3,1592,1.884,2,1812,1.104,5,3404,1.469,36,19150,1.88,0,2124,0,0,6517,0,0,8641,0,36,27791,1.295
2015,12,Delaware,Rural,Other,0,482,0,0,43,0,0,42,0,0,85,0,0,567,0,0,70,0,0,514,0,0,584,0,0,1151,0
2011,31,Onondaga,Urban,Commercial,82,52061,1.575,39,6966,5.599,2,10905,0.183,41,17871,2.294,123,69932,1.759,0,29926,0,1,40621,0.025,1,70547,0.014,124,140479,0.883
2011,18,Genesee,Rural,Commercial,2,10048,0.199,2,1101,1.817,1,1685,0.593,3,2786,1.077,5,12834,0.39,0,4664,0,0,15502,0,0,20166,0,5,33000,0.152
2010,61,Queens,Urban,Medicaid,53,210415,0.252,96,50312,1.908,3,33102,0.091,99,83414,1.187,152,293829,0.517,0,30893,0,0,2053,0,0,32946,0,152,326775,0.465
2010,46,Steuben,Rural,Commercial,1,13373,0.075,6,1546,3.881,1,2314,0.432,7,3860,1.813,8,17233,0.464,0,5615,0,0,76,0,0,5691,0,8,22924,0.349
2015,25,Madison,Urban,Other,2,702,2.849,1,50,20,0,59,0,1,109,9.174,3,811,3.699,0,160,0,0,275,0,0,435,0,3,1246,2.408
2012,31,Onondaga,Urban,Other,6,4268,1.406,4,575,6.957,0,390,0,4,965,4.145,10,5233,1.911,0,977,0,0,3037,0,0,4014,0,10,9247,1.081
2015,42,Schenectady,Urban,Medicare,5,11940,0.419,3,1148,2.613,13,6701,1.94,16,7849,2.038,21,19789,1.061,0,7658,0,1,26136,0.038,1,33794,0.03,22,53583,0.411
2012,35,Oswego,Urban,Medicare,7,5481,1.277,16,4526,3.535,1,1870,0.535,17,6396,2.658,24,11877,2.021,0,5658,0,0,10707,0,0,16365,0,24,28242,0.85
2011,62,Richmond (Staten Island),Urban,Medicaid,23,38605,0.596,86,10246,8.394,1,6532,0.153,87,16778,5.185,110,55383,1.986,0,5243,0,0,183384,0,0,188627,0,110,244010,0.451
2015,18,Genesee,Rural,Medicare,6,3712,1.616,5,2071,2.414,1,665,1.504,6,2736,2.193,12,6448,1.861,0,3206,0,0,13080,0,0,16286,0,12,22734,0.528
2014,3,Broome,Urban,Commercial,51,23182,2.2,11,2865,3.839,1,4071,0.246,12,6936,1.73,63,30118,2.092,0,13000,0,0,78356,0,0,91356,0,63,121474,0.519
2013,46,Steuben,Rural,Medicaid,8,11224,0.713,3,819,3.663,0,1252,0,3,2071,1.449,11,13295,0.827,0,1663,0,0,5647,0,0,7310,0,11,20605,0.534
2013,19,Greene,Rural,Medicare,3,2742,1.094,2,1992,1.004,0,611,0,2,2603,0.768,5,5345,0.935,0,2347,0,0,4344,0,0,6691,0,5,12036,0.415
2014,43,Schoharie,Urban,Commercial,2,4686,0.427,0,311,0,2,579,3.454,2,890,2.247,4,5576,0.717,0,2048,0,0,7075,0,0,9123,0,4,14699,0.272
2011,39,Rockland,Urban,Unknown,0,53,0,0,2,0,0,6,0,0,8,0,0,61,0,0,143,0,0,16,0,0,159,0,0,220,0
2015,59,Kings (Brooklyn),Urban,Medicare,46,102419,0.449,121,69975,1.729,29,21936,1.322,150,91911,1.632,196,194330,1.009,0,54506,0,6,358450,0.017,6,412956,0.015,202,607286,0.333
2015,31,Onondaga,Urban,Commercial,100,41388,2.416,43,6018,7.145,7,10061,0.696,50,16079,3.11,150,57467,2.61,0,37244,0,2,32380,0.062,2,69624,0.029,152,127091,1.196
2013,27,Montgomery,Rural,Commercial,3,11924,0.252,4,675,5.926,0,1052,0,4,1727,2.316,7,13651,0.513,0,4675,0,0,17030,0,0,21705,0,7,35356,0.198
2012,42,Schenectady,Urban,Medicare,5,11581,0.432,1,1197,0.835,5,6367,0.785,6,7564,0.793,11,19145,0.575,0,7762,0,0,16298,0,0,24060,0,11,43205,0.255
2011,23,Lewis,Rural,Other,0,851,0,0,35,0,0,96,0,0,131,0,0,982,0,0,132,0,0,511,0,0,643,0,0,1625,0
2011,59,Kings (Brooklyn),Urban,Commercial,83,373178,0.222,53,43519,1.218,10,41501,0.241,63,85020,0.741,146,458198,0.319,0,88002,0,0,536215,0,0,624217,0,146,1082415,0.135
2011,23,Lewis,Rural,Commercial,1,5100,0.196,1,355,2.817,0,565,0,1,920,1.087,2,6020,0.332,0,1787,0,0,4393,0,0,6180,0,2,12200,0.164
2015,61,Queens,Urban,Medicare,9,75361,0.119,98,62297,1.573,21,18873,1.113,119,81170,1.466,128,156531,0.818,0,44529,0,5,230632,0.022,5,275161,0.018,133,431692,0.308
2014,59,Kings (Brooklyn),Urban,Medicare,34,104110,0.327,114,78197,1.458,7,21053,0.332,121,99250,1.219,155,203360,0.762,0,56662,0,0,384852,0,0,441514,0,155,644874,0.24
2014,,Statewide Total,State,Other,106,218605,0.485,69,22673,3.043,10,16871,0.593,79,39544,1.998,185,258149,0.717,0,65604,0,1,226180,0.004,1,291784,0.003,186,549933,0.338
2011,8,Chenango,Rural,Commercial,8,10483,0.763,1,685,1.46,1,1161,0.861,2,1846,1.083,10,12329,0.811,0,3702,0,0,41372,0,0,45074,0,10,57403,0.174
2015,40,St. Lawrence,Rural,Other,2,6051,0.331,4,466,8.584,0,298,0,4,764,5.236,6,6815,0.88,0,876,0,0,2419,0,0,3295,0,6,10110,0.593
2013,55,Westchester,Urban,Other,2,14174,0.141,0,1641,0,2,880,2.273,2,2521,0.793,4,16695,0.24,0,2786,0,0,15442,0,0,18228,0,4,34923,0.115
2011,42,Schenectady,Urban,Other,0,988,0,1,76,13.158,0,376,0,1,452,2.212,1,1440,0.694,0,303,0,0,1214,0,0,1517,0,1,2957,0.338
2013,,Statewide Total,State,Other,92,234849,0.392,68,26554,2.561,8,17902,0.447,76,44456,1.71,168,279305,0.601,0,62104,0,0,241647,0,0,303751,0,168,583056,0.288
2011,35,Oswego,Urban,Commercial,7,12006,0.583,6,1878,3.195,1,2775,0.36,7,4653,1.504,14,16659,0.84,0,8549,0,0,5990,0,0,14539,0,14,31198,0.449
2014,32,Ontario,Urban,Medicaid,12,9063,1.324,6,642,9.346,0,1120,0,6,1762,3.405,18,10825,1.663,0,1786,0,0,5159,0,0,6945,0,18,17770,1.013
2015,54,Wayne,Urban,Medicaid,10,9909,1.009,6,909,6.601,0,953,0,6,1862,3.222,16,11771,1.359,0,2076,0,0,4342,0,0,6418,0,16,18189,0.88
2015,10,Columbia,Rural,Commercial,6,6645,0.903,0,781,0,0,836,0,0,1617,0,6,8262,0.726,0,3464,0,0,7258,0,0,10722,0,6,18984,0.316
2013,8,Chenango,Rural,Medicare,2,4752,0.421,2,1718,1.164,1,981,1.019,3,2699,1.112,5,7451,0.671,0,1792,0,0,43367,0,0,45159,0,5,52610,0.095
2013,9,Clinton,Rural,Commercial,6,17753,0.338,12,1492,8.043,0,1542,0,12,3034,3.955,18,20787,0.866,0,6512,0,0,16101,0,0,22613,0,18,43400,0.415
2014,38,Rensselaer,Urban,Commercial,21,16674,1.259,4,1872,2.137,0,3047,0,4,4919,0.813,25,21593,1.158,0,11006,0,0,15898,0,0,26904,0,25,48497,0.515
2012,13,Dutchess,Urban,Medicare,6,16024,0.374,20,9242,2.164,2,3488,0.573,22,12730,1.728,28,28754,0.974,0,8194,0,0,19633,0,0,27827,0,28,56581,0.495
2012,14,Erie,Urban,Other,6,12177,0.493,10,1316,7.599,0,1253,0,10,2569,3.893,16,14746,1.085,0,2699,0,0,5282,0,0,7981,0,16,22727,0.704
2013,4,Cattaraugus,Rural,Medicaid,2,2753,0.726,2,335,5.97,0,531,0,2,866,2.309,4,3619,1.105,0,840,0,0,3358,0,0,4198,0,4,7817,0.512
2015,32,Ontario,Urban,Medicare,4,6523,0.613,14,3413,4.102,2,1183,1.691,16,4596,3.481,20,11119,1.799,0,5001,0,0,12141,0,0,17142,0,20,28261,0.708
2011,62,Richmond (Staten Island),Urban,Commercial,30,81274,0.369,38,14277,2.662,3,12336,0.243,41,26613,1.541,71,107887,0.658,0,23707,0,2,76371,0.026,2,100078,0.02,73,207965,0.351
2015,15,Essex,Rural,Other,0,281,0,0,26,0,0,11,0,0,37,0,0,318,0,0,65,0,0,142,0,0,207,0,0,525,0
2011,99,Unknown,Urban,Medicare,6,22399,0.268,12,7770,1.544,3,4886,0.614,15,12656,1.185,21,35055,0.599,0,45657,0,1,73141,0.014,1,118798,0.008,22,153853,0.143
2011,34,Orleans,Urban,Other,0,655,0,0,110,0,0,65,0,0,175,0,0,830,0,0,157,0,0,321,0,0,478,0,0,1308,0
2013,24,Livingston,Urban,Medicare,4,3485,1.148,7,1889,3.706,0,750,0,7,2639,2.653,11,6124,1.796,0,3101,0,0,6177,0,0,9278,0,11,15402,0.714
2013,10,Columbia,Rural,Commercial,12,8564,1.401,3,950,3.158,0,1038,0,3,1988,1.509,15,10552,1.422,0,3860,0,0,7138,0,0,10998,0,15,21550,0.696
2011,40,St. Lawrence,Rural,Medicare,2,9906,0.202,7,3864,1.812,1,1669,0.599,8,5533,1.446,10,15439,0.648,0,4818,0,1,17254,0.058,1,22072,0.045,11,37511,0.293
2015,99,Unknown,Urban,Commercial,46,48168,0.955,20,4024,4.97,7,5802,1.206,27,9826,2.748,73,57994,1.259,0,31505,0,6,48760,0.123,6,80265,0.075,79,138259,0.571
2015,19,Greene,Rural,Medicare,9,2845,3.163,11,2320,4.741,0,705,0,11,3025,3.636,20,5870,3.407,0,2490,0,0,5892,0,0,8382,0,20,14252,1.403
2013,31,Onondaga,Urban,Medicaid,82,49844,1.645,38,5530,6.872,1,5628,0.178,39,11158,3.495,121,61002,1.984,0,6415,0,0,27408,0,0,33823,0,121,94825,1.276
2011,4,Cattaraugus,Rural,Commercial,5,13046,0.383,3,1078,2.783,0,1880,0,3,2958,1.014,8,16004,0.5,0,5525,0,0,12668,0,0,18193,0,8,34197,0.234
2013,30,Oneida,Urban,Commercial,23,27408,0.839,13,3020,4.305,1,4710,0.212,14,7730,1.811,37,35138,1.053,0,18070,0,0,23443,0,0,41513,0,37,76651,0.483
2015,58,Bronx,Urban,Medicare,22,76176,0.289,166,51735,3.209,21,11663,1.801,187,63398,2.95,209,139574,1.497,0,36732,0,2,343303,0.006,2,380035,0.005,211,519609,0.406
2015,32,Ontario,Urban,Other,5,2314,2.161,6,380,15.789,0,146,0,6,526,11.407,11,2840,3.873,0,412,0,0,853,0,0,1265,0,11,4105,2.68
2014,1,Albany,Urban,Commercial,29,35249,0.823,8,3793,2.109,0,5910,0,8,9703,0.824,37,44952,0.823,0,21149,0,0,45709,0,0,66858,0,37,111810,0.331
2011,59,Kings (Brooklyn),Urban,Medicaid,112,431685,0.259,232,91636,2.532,28,64264,0.436,260,155900,1.668,372,587585,0.633,1,59324,0.017,2,1091597,0.002,3,1150921,0.003,375,1738506,0.216
2014,35,Oswego,Urban,Medicaid,24,12876,1.864,8,1541,5.191,0,1931,0,8,3472,2.304,32,16348,1.957,0,3617,0,0,13333,0,0,16950,0,32,33298,0.961
2015,9,Clinton,Rural,Commercial,3,15304,0.196,3,991,3.027,2,1354,1.477,5,2345,2.132,8,17649,0.453,0,5406,0,0,13183,0,0,18589,0,8,36238,0.221
2011,99,Unknown,Urban,Medicaid,26,38986,0.667,15,3456,4.34,7,3740,1.872,22,7196,3.057,48,46182,1.039,0,9624,0,1,34951,0.029,1,44575,0.022,49,90757,0.54
2012,19,Greene,Rural,Medicaid,4,3726,1.074,5,600,8.333,0,590,0,5,1190,4.202,9,4916,1.831,0,724,0,0,1404,0,0,2128,0,9,7044,1.278
2012,16,Franklin,Rural,Commercial,2,4339,0.461,2,431,4.64,0,648,0,2,1079,1.854,4,5418,0.738,0,1677,0,0,3800,0,0,5477,0,4,10895,0.367
2011,16,Franklin,Rural,Medicaid,3,4807,0.624,0,539,0,0,583,0,0,1122,0,3,5929,0.506,0,577,0,1,4311,0.232,1,4888,0.205,4,10817,0.37
2012,8,Chenango,Rural,Medicaid,3,8493,0.353,5,406,12.315,0,838,0,5,1244,4.019,8,9737,0.822,0,655,0,0,24234,0,0,24889,0,8,34626,0.231
2010,61,Queens,Urban,Other,6,17425,0.344,7,5083,1.377,2,2680,0.746,9,7763,1.159,15,25188,0.596,0,3457,0,0,36,0,0,3493,0,15,28681,0.523
2013,42,Schenectady,Urban,Other,0,1415,0,0,82,0,1,425,2.353,1,507,1.972,1,1922,0.52,0,313,0,0,1858,0,0,2171,0,1,4093,0.244
2012,30,Oneida,Urban,Other,2,5082,0.394,4,505,7.921,0,418,0,4,923,4.334,6,6005,0.999,0,884,0,0,3552,0,0,4436,0,6,10441,0.575
2011,11,Cortland,Rural,Commercial,2,6779,0.295,2,767,2.608,1,1012,0.988,3,1779,1.686,5,8558,0.584,0,2312,0,0,3886,0,0,6198,0,5,14756,0.339
2012,12,Delaware,Rural,Medicare,5,5553,0.9,3,1054,2.846,5,1615,3.096,8,2669,2.997,13,8222,1.581,0,1999,0,0,19632,0,0,21631,0,13,29853,0.435
2013,11,Cortland,Rural,Medicare,2,4528,0.442,1,1700,0.588,1,787,1.271,2,2487,0.804,4,7015,0.57,0,2068,0,0,4787,0,0,6855,0,4,13870,0.288
2012,25,Madison,Urban,Commercial,7,10690,0.655,5,956,5.23,1,1680,0.595,6,2636,2.276,13,13326,0.976,0,5231,0,0,5751,0,0,10982,0,13,24308,0.535
2013,17,Fulton,Rural,Medicare,3,5371,0.559,1,2228,0.449,1,1129,0.886,2,3357,0.596,5,8728,0.573,0,3513,0,0,9980,0,0,13493,0,5,22221,0.225
2015,16,Franklin,Rural,Medicare,1,2174,0.46,5,727,6.878,0,334,0,5,1061,4.713,6,3235,1.855,0,946,0,0,5974,0,0,6920,0,6,10155,0.591
2015,30,Oneida,Urban,Medicare,11,17807,0.618,18,9652,1.865,7,3817,1.834,25,13469,1.856,36,31276,1.151,0,12639,0,1,28682,0.035,1,41321,0.024,37,72597,0.51
2013,38,Rensselaer,Urban,Commercial,8,11652,0.687,13,2252,5.773,0,3262,0,13,5514,2.358,21,17166,1.223,0,12153,0,0,17016,0,0,29169,0,21,46335,0.453
2014,39,Rockland,Urban,Medicare,3,14230,0.211,10,9028,1.108,1,3814,0.262,11,12842,0.857,14,27072,0.517,0,4576,0,0,29709,0,0,34285,0,14,61357,0.228
2015,49,Tioga,Urban,Commercial,6,2994,2.004,2,359,5.571,0,634,0,2,993,2.014,8,3987,2.007,0,2362,0,0,5856,0,0,8218,0,8,12205,0.655
2015,19,Greene,Rural,Medicaid,11,4400,2.5,5,683,7.321,1,638,1.567,6,1321,4.542,17,5721,2.972,0,981,0,2,2502,0.799,2,3483,0.574,19,9204,2.064
2015,54,Wayne,Urban,Medicare,2,6290,0.318,6,3778,1.588,3,1175,2.553,9,4953,1.817,11,11243,0.978,0,4978,0,0,15065,0,0,20043,0,11,31286,0.352
2013,62,Richmond (Staten Island),Urban,Other,12,13391,0.896,5,1078,4.638,0,315,0,5,1393,3.589,17,14784,1.15,0,979,0,0,24869,0,0,25848,0,17,40632,0.418
2011,21,Herkimer,Urban,Medicaid,6,6751,0.889,8,563,14.21,1,979,1.021,9,1542,5.837,15,8293,1.809,0,1781,0,0,20729,0,0,22510,0,15,30803,0.487
2011,8,Chenango,Rural,Medicare,1,4827,0.207,3,1877,1.598,5,992,5.04,8,2869,2.788,9,7696,1.169,1,2636,0.379,1,35243,0.028,2,37879,0.053,11,45575,0.241
2011,61,Queens,Urban,Medicaid,49,271828,0.18,92,53866,1.708,11,38658,0.285,103,92524,1.113,152,364352,0.417,1,36163,0.028,6,815712,0.007,7,851875,0.008,159,1216227,0.131
2013,33,Orange,Urban,Commercial,83,62467,1.329,40,6586,6.073,4,9607,0.416,44,16193,2.717,127,78660,1.615,0,22354,0,1,25259,0.04,1,47613,0.021,128,126273,1.014
2015,30,Oneida,Urban,Medicaid,72,34875,2.065,28,3323,8.426,4,4227,0.946,32,7550,4.238,104,42425,2.451,0,5441,0,1,22267,0.045,1,27708,0.036,105,70133,1.497
2014,45,Seneca,Rural,Commercial,5,5104,0.98,3,477,6.289,2,751,2.663,5,1228,4.072,10,6332,1.579,0,2629,0,0,4457,0,0,7086,0,10,13418,0.745
2013,41,Saratoga,Urban,Medicare,2,9758,0.205,6,5135,1.168,1,3074,0.325,7,8209,0.853,9,17967,0.501,0,11297,0,1,16711,0.06,1,28008,0.036,10,45975,0.218
2013,34,Orleans,Urban,Other,1,578,1.73,0,96,0,0,68,0,0,164,0,1,742,1.348,0,177,0,0,474,0,0,651,0,1,1393,0.718
2011,54,Wayne,Urban,Commercial,4,14833,0.27,6,1816,3.304,2,2805,0.713,8,4621,1.731,12,19454,0.617,0,7127,0,0,13380,0,0,20507,0,12,39961,0.3
2013,99,Unknown,Urban,Other,2,8939,0.224,3,571,5.254,0,386,0,3,957,3.135,5,9896,0.505,0,3021,0,0,3726,0,0,6747,0,5,16643,0.3
2014,10,Columbia,Rural,Commercial,8,7530,1.062,3,900,3.333,0,906,0,3,1806,1.661,11,9336,1.178,0,3841,0,0,6640,0,0,10481,0,11,19817,0.555
2012,55,Westchester,Urban,Medicaid,30,78615,0.382,56,10949,5.115,10,13280,0.753,66,24229,2.724,96,102844,0.933,0,7392,0,0,137541,0,0,144933,0,96,247777,0.387
2014,41,Saratoga,Urban,Other,0,1813,0,0,159,0,0,403,0,0,562,0,0,2375,0,0,656,0,0,1557,0,0,2213,0,0,4588,0
2014,14,Erie,Urban,Medicaid,226,128548,1.758,88,11815,7.448,3,13235,0.227,91,25050,3.633,317,153598,2.064,0,14664,0,1,80620,0.012,1,95284,0.01,318,248882,1.278
2014,55,Westchester,Urban,Commercial,59,123530,0.478,33,14618,2.257,10,19829,0.504,43,34447,1.248,102,157977,0.646,0,47278,0,0,137311,0,0,184589,0,102,342566,0.298
2013,61,Queens,Urban,Other,6,18319,0.328,7,3496,2.002,1,1441,0.694,8,4937,1.62,14,23256,0.602,0,6437,0,0,45295,0,0,51732,0,14,74988,0.187
2015,36,Otsego,Rural,Medicare,2,5517,0.363,8,2225,3.596,4,1021,3.918,12,3246,3.697,14,8763,1.598,0,3075,0,1,65101,0.015,1,68176,0.015,15,76939,0.195
2014,20,Hamilton,Rural,Commercial,1,426,2.347,1,63,15.873,0,85,0,1,148,6.757,2,574,3.484,0,303,0,0,475,0,0,778,0,2,1352,1.479
2014,35,Oswego,Urban,Other,1,1013,0.987,0,116,0,0,113,0,0,229,0,1,1242,0.805,0,354,0,0,616,0,0,970,0,1,2212,0.452
2015,1,Albany,Urban,Other,3,2384,1.258,1,188,5.319,0,143,0,1,331,3.021,4,2715,1.473,0,484,0,1,4044,0.247,1,4528,0.221,5,7243,0.69
2015,44,Schuyler,Rural,Other,1,235,4.255,0,14,0,0,15,0,0,29,0,1,264,3.788,0,85,0,0,274,0,0,359,0,1,623,1.605
2014,1,Albany,Urban,Medicaid,31,36700,0.845,17,3615,4.703,2,3461,0.578,19,7076,2.685,50,43776,1.142,0,4282,0,0,30965,0,0,35247,0,50,79023,0.633
2014,41,Saratoga,Urban,Medicare,5,10312,0.485,6,5178,1.159,1,3300,0.303,7,8478,0.826,12,18790,0.639,0,11110,0,0,20202,0,0,31312,0,12,50102,0.24
2012,48,Sullivan,Rural,Medicare,3,4643,0.646,8,2435,3.285,0,1224,0,8,3659,2.186,11,8302,1.325,0,2421,0,0,6603,0,0,9024,0,11,17326,0.635
2014,28,Nassau,Urban,Medicaid,91,93113,0.977,102,15950,6.395,8,13070,0.612,110,29020,3.79,201,122133,1.646,0,13454,0,0,125959,0,0,139413,0,201,261546,0.769
2014,22,Jefferson,Urban,Other,7,18959,0.369,5,948,5.274,0,2573,0,5,3521,1.42,12,22480,0.534,0,3637,0,0,5028,0,0,8665,0,12,31145,0.385
2011,60,New York (Manhattan),Urban,Commercial,82,225941,0.363,55,28043,1.961,16,36249,0.441,71,64292,1.104,153,290233,0.527,0,75110,0,0,241561,0,0,316671,0,153,606904,0.252
2015,9,Clinton,Rural,Medicaid,4,10807,0.37,4,734,5.45,2,715,2.797,6,1449,4.141,10,12256,0.816,1,1233,0.811,0,4640,0,1,5873,0.17,11,18129,0.607
2012,6,Chautauqua,Rural,Other,1,1653,0.605,1,106,9.434,0,149,0,1,255,3.922,2,1908,1.048,0,224,0,0,1366,0,0,1590,0,2,3498,0.572
2014,59,Kings (Brooklyn),Urban,Commercial,128,360304,0.355,54,37432,1.443,7,39963,0.175,61,77395,0.788,189,437699,0.432,0,84383,0,1,522407,0.002,1,606790,0.002,190,1044489,0.182
2013,13,Dutchess,Urban,Medicare,14,17135,0.817,16,9032,1.771,1,3288,0.304,17,12320,1.38,31,29455,1.052,0,9552,0,0,24181,0,0,33733,0,31,63188,0.491
2012,26,Monroe,Urban,Commercial,68,95820,0.71,52,11897,4.371,1,17182,0.058,53,29079,1.823,121,124899,0.969,0,41676,0,1,83364,0.012,1,125040,0.008,122,249939,0.488
2012,2,Allegany,Rural,Commercial,1,9871,0.101,2,551,3.63,0,896,0,2,1447,1.382,3,11318,0.265,0,2482,0,0,8907,0,0,11389,0,3,22707,0.132
2013,99,Unknown,Urban,Commercial,64,111246,0.575,21,8132,2.582,1,9573,0.104,22,17705,1.243,86,128951,0.667,0,43880,0,0,68795,0,0,112675,0,86,241626,0.356
2015,48,Sullivan,Rural,Medicaid,7,5385,1.3,12,848,14.151,2,1048,1.908,14,1896,7.384,21,7281,2.884,0,1112,0,0,3163,0,0,4275,0,21,11556,1.817
2010,59,Kings (Brooklyn),Urban,Medicaid,104,380977,0.273,195,77352,2.521,34,62955,0.54,229,140307,1.632,333,521284,0.639,0,56479,0,0,407,0,0,56886,0,333,578170,0.576
2014,12,Delaware,Rural,Medicare,1,5981,0.167,1,1116,0.896,0,1533,0,1,2649,0.378,2,8630,0.232,0,2208,0,0,30501,0,0,32709,0,2,41339,0.048
2014,62,Richmond (Staten Island),Urban,Medicaid,72,58450,1.232,84,12035,6.98,2,6536,0.306,86,18571,4.631,158,77021,2.051,1,6678,0.15,1,132567,0.008,2,139245,0.014,160,216266,0.74
2014,34,Orleans,Urban,Commercial,6,6462,0.929,1,756,1.323,0,950,0,1,1706,0.586,7,8168,0.857,0,2796,0,0,4623,0,0,7419,0,7,15587,0.449
2012,47,Suffolk,Urban,Other,3,13210,0.227,8,1303,6.14,0,542,0,8,1845,4.336,11,15055,0.731,0,5030,0,0,2167,0,0,7197,0,11,22252,0.494
2011,61,Queens,Urban,Commercial,55,325863,0.169,53,45013,1.177,7,45117,0.155,60,90130,0.666,115,415993,0.276,0,73260,0,4,478109,0.008,4,551369,0.007,119,967362,0.123
2012,33,Orange,Urban,Medicare,6,15179,0.395,28,11134,2.515,3,4756,0.631,31,15890,1.951,37,31069,1.191,0,10152,0,0,19920,0,0,30072,0,37,61141,0.605
2014,16,Franklin,Rural,Medicaid,1,2200,0.455,3,218,13.761,0,299,0,3,517,5.803,4,2717,1.472,0,361,0,0,2018,0,0,2379,0,4,5096,0.785
2013,59,Kings (Brooklyn),Urban,Commercial,92,349889,0.263,50,39321,1.272,4,39003,0.103,54,78324,0.689,146,428213,0.341,0,83020,0,0,538249,0,0,621269,0,146,1049482,0.139
2010,47,Suffolk,Urban,Medicaid,58,55014,1.054,103,13044,7.896,3,12977,0.231,106,26021,4.074,164,81035,2.024,0,5171,0,0,189,0,0,5360,0,164,86395,1.898
2011,17,Fulton,Rural,Commercial,2,5282,0.379,5,749,6.676,0,1195,0,5,1944,2.572,7,7226,0.969,0,4396,0,0,7352,0,0,11748,0,7,18974,0.369
2015,23,Lewis,Rural,Commercial,2,5400,0.37,3,355,8.451,1,601,1.664,4,956,4.184,6,6356,0.944,0,1656,0,0,3691,0,0,5347,0,6,11703,0.513
2011,60,New York (Manhattan),Urban,Other,1,8454,0.118,5,1221,4.095,1,539,1.855,6,1760,3.409,7,10214,0.685,0,1357,0,0,12026,0,0,13383,0,7,23597,0.297
2011,51,Ulster,Urban,Medicare,3,9417,0.319,11,7185,1.531,1,3367,0.297,12,10552,1.137,15,19969,0.751,0,6399,0,0,12437,0,0,18836,0,15,38805,0.387
2010,54,Wayne,Urban,Commercial,6,12992,0.462,5,1671,2.992,0,2658,0,5,4329,1.155,11,17321,0.635,0,6411,0,0,169,0,0,6580,0,11,23901,0.46
2013,57,Yates,Urban,Medicaid,2,2562,0.781,0,103,0,0,239,0,0,342,0,2,2904,0.689,0,403,0,0,1137,0,0,1540,0,2,4444,0.45
2014,4,Cattaraugus,Rural,Medicaid,7,2894,2.419,2,361,5.54,0,581,0,2,942,2.123,9,3836,2.346,0,863,0,0,3632,0,0,4495,0,9,8331,1.08
2014,5,Cayuga,Rural,Commercial,14,8787,1.593,2,1001,1.998,2,1669,1.198,4,2670,1.498,18,11457,1.571,0,6824,0,0,12981,0,0,19805,0,18,31262,0.576
2011,30,Oneida,Urban,Commercial,10,33558,0.298,12,3328,3.606,3,5444,0.551,15,8772,1.71,25,42330,0.591,0,20244,0,1,22152,0.045,1,42396,0.024,26,84726,0.307
2014,8,Chenango,Rural,Commercial,6,10334,0.581,1,533,1.876,0,1276,0,1,1809,0.553,7,12143,0.576,0,3589,0,1,13294,0.075,1,16883,0.059,8,29026,0.276
2013,25,Madison,Urban,Medicare,0,4462,0,3,1857,1.616,0,971,0,3,2828,1.061,3,7290,0.412,0,4332,0,0,9838,0,0,14170,0,3,21460,0.14
2014,44,Schuyler,Rural,Medicare,0,2248,0,0,360,0,0,640,0,0,1000,0,0,3248,0,0,845,0,0,9587,0,0,10432,0,0,13680,0
2014,36,Otsego,Rural,Medicaid,8,4480,1.786,2,417,4.796,3,640,4.688,5,1057,4.73,13,5537,2.348,0,926,0,0,17929,0,0,18855,0,13,24392,0.533
2011,56,Wyoming,Rural,Commercial,3,7451,0.403,1,702,1.425,0,1177,0,1,1879,0.532,4,9330,0.429,0,3467,0,0,6515,0,0,9982,0,4,19312,0.207
2011,48,Sullivan,Rural,Commercial,8,7933,1.008,2,1212,1.65,2,1660,1.205,4,2872,1.393,12,10805,1.111,0,3720,0,0,6716,0,0,10436,0,12,21241,0.565
2013,12,Delaware,Rural,Medicaid,7,5906,1.185,3,279,10.753,1,545,1.835,4,824,4.854,11,6730,1.634,0,623,0,1,20895,0.048,1,21518,0.046,12,28248,0.425
2011,6,Chautauqua,Rural,Commercial,13,25165,0.517,11,1699,6.474,2,2491,0.803,13,4190,3.103,26,29355,0.886,0,9404,0,0,49713,0,0,59117,0,26,88472,0.294
2013,17,Fulton,Rural,Commercial,3,11729,0.256,4,816,4.902,0,1042,0,4,1858,2.153,7,13587,0.515,0,4652,0,0,10832,0,0,15484,0,7,29071,0.241
2014,12,Delaware,Rural,Commercial,7,7861,0.89,4,392,10.204,1,969,1.032,5,1361,3.674,12,9222,1.301,0,2566,0,0,17191,0,0,19757,0,12,28979,0.414
2014,18,Genesee,Rural,Commercial,17,7695,2.209,4,789,5.07,0,1380,0,4,2169,1.844,21,9864,2.129,0,4694,0,0,16609,0,0,21303,0,21,31167,0.674
2012,48,Sullivan,Rural,Other,2,2556,0.782,1,236,4.237,0,117,0,1,353,2.833,3,2909,1.031,0,380,0,0,736,0,0,1116,0,3,4025,0.745
2014,49,Tioga,Urban,Medicaid,10,1796,5.568,3,229,13.1,0,331,0,3,560,5.357,13,2356,5.518,0,430,0,0,3615,0,0,4045,0,13,6401,2.031
2013,51,Ulster,Urban,Medicaid,20,18261,1.095,6,1484,4.043,1,2358,0.424,7,3842,1.822,27,22103,1.222,0,2095,0,0,4914,0,0,7009,0,27,29112,0.927
2012,9,Clinton,Rural,Medicare,0,6588,0,8,2745,2.914,0,723,0,8,3468,2.307,8,10056,0.796,0,4125,0,0,13518,0,0,17643,0,8,27699,0.289
2012,25,Madison,Urban,Medicare,0,4633,0,1,1936,0.517,2,1056,1.894,3,2992,1.003,3,7625,0.393,0,2797,0,0,5327,0,0,8124,0,3,15749,0.19
2013,53,Washington,Urban,Commercial,2,6938,0.288,5,925,5.405,0,1120,0,5,2045,2.445,7,8983,0.779,0,3896,0,0,5668,0,0,9564,0,7,18547,0.377
2012,31,Onondaga,Urban,Commercial,65,55969,1.161,44,7080,6.215,2,10958,0.183,46,18038,2.55,111,74007,1.5,0,31731,0,0,34648,0,0,66379,0,111,140386,0.791
2011,37,Putnam,Urban,Commercial,7,16001,0.437,8,1927,4.152,0,2594,0,8,4521,1.77,15,20522,0.731,0,5527,0,0,8397,0,0,13924,0,15,34446,0.435
2014,23,Lewis,Rural,Medicare,0,1572,0,1,532,1.88,1,526,1.901,2,1058,1.89,2,2630,0.76,0,954,0,0,1975,0,0,2929,0,2,5559,0.36
2015,13,Dutchess,Urban,Medicare,25,16716,1.496,26,10267,2.532,2,3362,0.595,28,13629,2.054,53,30345,1.747,0,10384,0,0,23230,0,0,33614,0,53,63959,0.829
2014,51,Ulster,Urban,Other,1,2470,0.405,0,326,0,0,191,0,0,517,0,1,2987,0.335,0,875,0,0,983,0,0,1858,0,1,4845,0.206
2011,15,Essex,Rural,Commercial,4,8091,0.494,3,513,5.848,1,636,1.572,4,1149,3.481,8,9240,0.866,0,2594,0,0,7825,0,0,10419,0,8,19659,0.407
2014,57,Yates,Urban,Medicare,1,2103,0.476,0,651,0,0,424,0,0,1075,0,1,3178,0.315,0,1358,0,0,4076,0,0,5434,0,1,8612,0.116
2011,33,Orange,Urban,Commercial,28,49932,0.561,31,7364,4.21,4,9795,0.408,35,17159,2.04,63,67091,0.939,0,22696,0,0,32389,0,0,55085,0,63,122176,0.516
2013,44,Schuyler,Rural,Commercial,7,3230,2.167,0,234,0,0,388,0,0,622,0,7,3852,1.817,0,1121,0,0,5636,0,0,6757,0,7,10609,0.66
2015,8,Chenango,Rural,Medicare,2,5915,0.338,5,1452,3.444,4,1115,3.587,9,2567,3.506,11,8482,1.297,0,2805,0,0,17293,0,0,20098,0,11,28580,0.385
2013,88,Other than New York State,Urban,Medicaid,12,8835,1.358,12,1616,7.426,2,961,2.081,14,2577,5.433,26,11412,2.278,0,545,0,0,3033,0,0,3578,0,26,14990,1.734
2014,99,Unknown,Urban,Other,4,7907,0.506,6,540,11.111,0,223,0,6,763,7.864,10,8670,1.153,0,4012,0,0,2030,0,0,6042,0,10,14712,0.68
2015,53,Washington,Urban,Medicaid,8,5841,1.37,1,869,1.151,0,810,0,1,1679,0.596,9,7520,1.197,0,1494,0,0,3173,0,0,4667,0,9,12187,0.738
2014,31,Onondaga,Urban,Medicaid,102,53879,1.893,41,6103,6.718,0,6119,0,41,12222,3.355,143,66101,2.163,1,7857,0.127,0,29020,0,1,36877,0.027,144,102978,1.398
2011,29,Niagara,Urban,Commercial,20,37701,0.53,22,6042,3.641,4,6408,0.624,26,12450,2.088,46,50151,0.917,0,21006,0,0,53928,0,0,74934,0,46,125085,0.368
2011,26,Monroe,Urban,Medicare,23,39213,0.587,54,27609,1.956,3,8098,0.37,57,35707,1.596,80,74920,1.068,0,23556,0,0,75694,0,0,99250,0,80,174170,0.459
2013,61,Queens,Urban,Medicaid,54,300585,0.18,126,54236,2.323,21,41586,0.505,147,95822,1.534,201,396407,0.507,0,41390,0,1,767351,0.001,1,808741,0.001,202,1205148,0.168
2011,16,Franklin,Rural,Commercial,3,7816,0.384,3,815,3.681,0,1077,0,3,1892,1.586,6,9708,0.618,1,2738,0.365,0,6927,0,1,9665,0.103,7,19373,0.361
2013,36,Otsego,Rural,Medicare,0,4608,0,3,1994,1.505,0,1073,0,3,3067,0.978,3,7675,0.391,0,2859,0,0,75511,0,0,78370,0,3,86045,0.035
2013,42,Schenectady,Urban,Medicaid,19,26826,0.708,4,697,5.739,15,3613,4.152,19,4310,4.408,38,31136,1.22,0,2609,0,0,14572,0,0,17181,0,38,48317,0.786
2013,11,Cortland,Rural,Commercial,7,8836,0.792,1,588,1.701,1,924,1.082,2,1512,1.323,9,10348,0.87,0,3102,0,0,5230,0,0,8332,0,9,18680,0.482
2013,7,Chemung,Urban,Other,0,982,0,0,179,0,0,74,0,0,253,0,0,1235,0,0,253,0,0,2221,0,0,2474,0,0,3709,0
2012,26,Monroe,Urban,Medicare,26,42595,0.61,62,26848,2.309,3,7364,0.407,65,34212,1.9,91,76807,1.185,0,22996,0,0,74658,0,0,97654,0,91,174461,0.522
2014,8,Chenango,Rural,Medicare,4,5946,0.673,2,1529,1.308,3,1020,2.941,5,2549,1.962,9,8495,1.059,0,2565,0,0,21487,0,0,24052,0,9,32547,0.277
2012,62,Richmond (Staten Island),Urban,Medicaid,42,52704,0.797,101,11343,8.904,7,6801,1.029,108,18144,5.952,150,70848,2.117,0,5904,0,0,142733,0,0,148637,0,150,219485,0.683
2014,2,Allegany,Rural,Medicare,2,3584,0.558,2,1084,1.845,0,530,0,2,1614,1.239,4,5198,0.77,0,1656,0,0,5405,0,0,7061,0,4,12259,0.326
2012,60,New York (Manhattan),Urban,Medicaid,55,242592,0.227,171,37021,4.619,19,26499,0.717,190,63520,2.991,245,306112,0.8,0,21584,0,1,558009,0.002,1,579593,0.002,246,885705,0.278
2015,24,Livingston,Urban,Medicaid,5,4718,1.06,2,445,4.494,0,554,0,2,999,2.002,7,5717,1.224,0,1103,0,0,6480,0,0,7583,0,7,13300,0.526
2015,11,Cortland,Rural,Medicaid,15,9227,1.626,6,603,9.95,1,652,1.534,7,1255,5.578,22,10482,2.099,0,1066,0,0,2663,0,0,3729,0,22,14211,1.548
2015,11,Cortland,Rural,Other,2,452,4.425,0,24,0,0,18,0,0,42,0,2,494,4.049,0,78,0,0,191,0,0,269,0,2,763,2.621
2011,36,Otsego,Rural,Commercial,6,9583,0.626,7,866,8.083,2,1118,1.789,9,1984,4.536,15,11567,1.297,0,7247,0,1,49511,0.02,1,56758,0.018,16,68325,0.234
2011,49,Tioga,Urban,Medicaid,2,1755,1.14,2,247,8.097,0,407,0,2,654,3.058,4,2409,1.66,0,235,0,0,5641,0,0,5876,0,4,8285,0.483
2012,3,Broome,Urban,Other,3,3562,0.842,3,283,10.601,0,125,0,3,408,7.353,6,3970,1.511,0,355,0,0,1824,0,0,2179,0,6,6149,0.976
2013,36,Otsego,Rural,Commercial,10,8563,1.168,1,759,1.318,0,1312,0,1,2071,0.483,11,10634,1.034,0,4376,0,0,36967,0,0,41343,0,11,51977,0.212
2013,62,Richmond (Staten Island),Urban,Medicare,12,20611,0.582,51,20029,2.546,1,4906,0.204,52,24935,2.085,64,45546,1.405,0,13841,0,0,93708,0,0,107549,0,64,153095,0.418
2015,50,Tompkins,Urban,Other,0,449,0,0,52,0,0,28,0,0,80,0,0,529,0,0,72,0,0,443,0,0,515,0,0,1044,0
2015,34,Orleans,Urban,Medicare,2,2126,0.941,0,988,0,2,779,2.567,2,1767,1.132,4,3893,1.027,0,1628,0,0,4272,0,0,5900,0,4,9793,0.408
2013,5,Cayuga,Rural,Medicare,3,4934,0.608,1,2238,0.447,1,1932,0.518,2,4170,0.48,5,9104,0.549,0,4091,0,0,7754,0,0,11845,0,5,20949,0.239
2015,40,St. Lawrence,Rural,Commercial,11,22792,0.483,5,1644,3.041,1,2376,0.421,6,4020,1.493,17,26812,0.634,0,8372,0,0,17155,0,0,25527,0,17,52339,0.325
2015,36,Otsego,Rural,Medicaid,14,5070,2.761,3,447,6.711,1,598,1.672,4,1045,3.828,18,6115,2.944,0,969,0,2,18947,0.106,2,19916,0.1,20,26031,0.768
2014,27,Montgomery,Rural,Medicaid,4,12839,0.312,8,705,11.348,1,1060,0.943,9,1765,5.099,13,14604,0.89,0,1741,0,0,16625,0,0,18366,0,13,32970,0.394
2015,19,Greene,Rural,Other,0,561,0,0,200,0,0,51,0,0,251,0,0,812,0,0,294,0,0,517,0,0,811,0,0,1623,0
2011,59,Kings (Brooklyn),Urban,Other,3,15833,0.189,6,3053,1.965,1,1117,0.895,7,4170,1.679,10,20003,0.5,0,3049,0,0,26286,0,0,29335,0,10,49338,0.203
2014,31,Onondaga,Urban,Commercial,85,45728,1.859,21,6264,3.352,1,10516,0.095,22,16780,1.311,107,62508,1.712,0,36478,0,0,31237,0,0,67715,0,107,130223,0.822
2014,46,Steuben,Rural,Medicare,3,9307,0.322,10,3170,3.155,1,1511,0.662,11,4681,2.35,14,13988,1.001,0,4802,0,0,24665,0,0,29467,0,14,43455,0.322
2010,,Statewide Total,State,All Payers,2555,6298662,0.406,3434,1477474,2.324,422,1144876,0.369,3856,2622350,1.47,6411,8921012,0.719,12,2286791,0.005,1,38323,0.026,13,2325114,0.006,6424,11246126,0.571
2012,59,Kings (Brooklyn),Urban,Commercial,112,372212,0.301,54,44051,1.226,9,40050,0.225,63,84101,0.749,175,456313,0.384,0,83881,0,1,538808,0.002,1,622689,0.002,176,1079002,0.163
2012,1,Albany,Urban,Other,1,2923,0.342,0,256,0,0,149,0,0,405,0,1,3328,0.3,0,480,0,0,6318,0,0,6798,0,1,10126,0.099
2012,62,Richmond (Staten Island),Urban,Medicare,19,19478,0.975,57,20535,2.776,3,5271,0.569,60,25806,2.325,79,45284,1.745,0,12204,0,0,97445,0,0,109649,0,79,154933,0.51
2011,26,Monroe,Urban,Other,2,6071,0.329,4,726,5.51,0,438,0,4,1164,3.436,6,7235,0.829,0,902,0,0,5441,0,0,6343,0,6,13578,0.442
2015,1,Albany,Urban,Medicare,9,20079,0.448,18,10238,1.758,3,3394,0.884,21,13632,1.54,30,33711,0.89,0,13305,0,1,57031,0.018,1,70336,0.014,31,104047,0.298
2014,61,Queens,Urban,Medicare,20,79846,0.25,57,58707,0.971,16,25576,0.626,73,84283,0.866,93,164129,0.567,0,48486,0,0,266033,0,0,314519,0,93,478648,0.194
2011,47,Suffolk,Urban,Medicaid,81,73759,1.098,116,15818,7.333,10,12041,0.83,126,27859,4.523,207,101618,2.037,0,7548,0,3,38550,0.078,3,46098,0.065,210,147716,1.422
2011,39,Rockland,Urban,Other,0,2059,0,0,292,0,0,144,0,0,436,0,0,2495,0,0,120,0,0,1619,0,0,1739,0,0,4234,0
2015,47,Suffolk,Urban,Medicare,59,74830,0.788,136,55290,2.46,38,17256,2.202,174,72546,2.398,233,147376,1.581,0,62581,0,1,87524,0.011,1,150105,0.007,234,297481,0.787
2015,20,Hamilton,Rural,Commercial,0,426,0,0,49,0,0,73,0,0,122,0,0,548,0,0,313,0,0,520,0,0,833,0,0,1381,0
2012,,Statewide Total,State,Commercial,1641,3128154,0.525,1161,379477,3.059,133,449143,0.296,1294,828620,1.562,2935,3956774,0.742,0,1104601,0,14,3123934,0.004,14,4228535,0.003,2949,8185309,0.36
2011,55,Westchester,Urban,Commercial,44,129588,0.34,44,17167,2.563,7,21968,0.319,51,39135,1.303,95,168723,0.563,0,43737,0,0,130639,0,0,174376,0,95,343099,0.277
2015,,Statewide Total,State,Other,132,201543,0.655,80,19643,4.073,17,15841,1.073,97,35484,2.734,229,237027,0.966,0,65591,0,2,214243,0.009,2,279834,0.007,231,516861,0.447
2012,37,Putnam,Urban,Medicare,3,4096,0.732,3,2856,1.05,1,1066,0.938,4,3922,1.02,7,8018,0.873,0,2407,0,0,4678,0,0,7085,0,7,15103,0.463
2015,43,Schoharie,Urban,Medicaid,9,3599,2.501,0,235,0,0,388,0,0,623,0,9,4222,2.132,0,578,0,0,7242,0,0,7820,0,9,12042,0.747
2011,33,Orange,Urban,Medicare,10,14263,0.701,20,11586,1.726,2,5271,0.379,22,16857,1.305,32,31120,1.028,0,9782,0,0,23314,0,0,33096,0,32,64216,0.498
2014,3,Broome,Urban,Medicaid,56,25497,2.196,21,2368,8.868,2,3004,0.666,23,5372,4.281,79,30869,2.559,0,3414,0,2,60350,0.033,2,63764,0.031,81,94633,0.856
2015,14,Erie,Urban,Medicare,65,62074,1.047,124,30527,4.062,29,10194,2.845,153,40721,3.757,218,102795,2.121,1,37183,0.027,2,75857,0.026,3,113040,0.027,221,215835,1.024
2010,58,Bronx,Urban,Medicare,14,57313,0.244,58,50281,1.154,9,13949,0.645,67,64230,1.043,81,121543,0.666,0,25489,0,0,255,0,0,25744,0,81,147287,0.55
2012,18,Genesee,Rural,Medicaid,6,5334,1.125,2,477,4.193,0,702,0,2,1179,1.696,8,6513,1.228,0,803,0,0,6483,0,0,7286,0,8,13799,0.58
2012,24,Livingston,Urban,Other,0,832,0,1,137,7.299,0,49,0,1,186,5.376,1,1018,0.982,0,190,0,0,388,0,0,578,0,1,1596,0.627
2015,59,Kings (Brooklyn),Urban,Commercial,139,368892,0.377,128,40463,3.163,16,40816,0.392,144,81279,1.772,283,450171,0.629,1,85772,0.012,0,608281,0,1,694053,0.001,284,1144224,0.248
2011,37,Putnam,Urban,Other,0,1028,0,1,162,6.173,0,55,0,1,217,4.608,1,1245,0.803,0,159,0,0,461,0,0,620,0,1,1865,0.536
2014,36,Otsego,Rural,Other,0,563,0,1,65,15.385,0,41,0,1,106,9.434,1,669,1.495,0,128,0,0,1320,0,0,1448,0,1,2117,0.472
2015,46,Steuben,Rural,Medicaid,6,13998,0.429,5,751,6.658,5,1390,3.597,10,2141,4.671,16,16139,0.991,0,2207,0,0,9523,0,0,11730,0,16,27869,0.574
2012,55,Westchester,Urban,Other,0,12868,0,2,1637,1.222,1,774,1.292,3,2411,1.244,3,15279,0.196,0,2329,0,0,15701,0,0,18030,0,3,33309,0.09
2011,27,Montgomery,Rural,Commercial,2,11852,0.169,2,775,2.581,1,1098,0.911,3,1873,1.602,5,13725,0.364,0,4922,0,0,16027,0,0,20949,0,5,34674,0.144
2014,6,Chautauqua,Rural,Other,1,1591,0.629,1,101,9.901,1,154,6.494,2,255,7.843,3,1846,1.625,0,270,0,0,1192,0,0,1462,0,3,3308,0.907
2013,27,Montgomery,Rural,Medicare,5,6048,0.827,9,2147,4.192,0,1112,0,9,3259,2.762,14,9307,1.504,0,3289,0,0,20980,0,0,24269,0,14,33576,0.417
2011,55,Westchester,Urban,Medicare,9,35452,0.254,31,31249,0.992,4,13381,0.299,35,44630,0.784,44,80082,0.549,0,22047,0,0,95879,0,0,117926,0,44,198008,0.222
2014,58,Bronx,Urban,Medicare,35,72839,0.481,111,49773,2.23,12,11832,1.014,123,61605,1.997,158,134444,1.175,0,36978,0,0,338503,0,0,375481,0,158,509925,0.31
2010,99,Unknown,Urban,Commercial,40,104423,0.383,20,11081,1.805,1,12413,0.081,21,23494,0.894,61,127917,0.477,0,70053,0,0,276,0,0,70329,0,61,198246,0.308
2012,2,Allegany,Rural,Medicaid,4,6659,0.601,2,335,5.97,0,547,0,2,882,2.268,6,7541,0.796,0,716,0,0,6052,0,0,6768,0,6,14309,0.419
2013,54,Wayne,Urban,Medicare,3,5919,0.507,9,3799,2.369,1,1313,0.762,10,5112,1.956,13,11031,1.178,0,4449,0,0,10173,0,0,14622,0,13,25653,0.507
2011,32,Ontario,Urban,Medicaid,6,8462,0.709,8,662,12.085,0,1074,0,8,1736,4.608,14,10198,1.373,0,1536,0,0,4030,0,0,5566,0,14,15764,0.888
2015,11,Cortland,Rural,Commercial,4,7053,0.567,2,540,3.704,2,796,2.513,4,1336,2.994,8,8389,0.954,0,3192,0,1,3711,0.269,1,6903,0.145,9,15292,0.589
2013,46,Steuben,Rural,Medicare,5,8851,0.565,7,3323,2.107,2,1489,1.343,9,4812,1.87,14,13663,1.025,0,4888,0,0,16814,0,0,21702,0,14,35365,0.396
2013,45,Seneca,Rural,Commercial,6,4895,1.226,4,426,9.39,0,774,0,4,1200,3.333,10,6095,1.641,0,2448,0,0,4358,0,0,6806,0,10,12901,0.775
2015,57,Yates,Urban,Medicaid,6,3323,1.806,3,172,17.442,0,250,0,3,422,7.109,9,3745,2.403,0,538,0,0,1535,0,0,2073,0,9,5818,1.547
2012,38,Rensselaer,Urban,Other,0,1494,0,2,204,9.804,0,89,0,2,293,6.826,2,1787,1.119,0,246,0,0,1641,0,0,1887,0,2,3674,0.544
2013,88,Other than New York State,Urban,Commercial,41,66655,0.615,23,9409,2.444,7,20360,0.344,30,29769,1.008,71,96424,0.736,0,40536,0,1,66445,0.015,1,106981,0.009,72,203405,0.354
2012,,Statewide Total,State,Medicare,384,958542,0.401,1191,696058,1.711,119,258065,0.461,1310,954123,1.373,1694,1912665,0.886,0,606131,0,4,2593007,0.002,4,3199138,0.001,1698,5111803,0.332
2010,1,Albany,Urban,Other,0,2168,0,1,218,4.587,0,217,0,1,435,2.299,1,2603,0.384,0,808,0,0,8,0,0,816,0,1,3419,0.292
2014,54,Wayne,Urban,Medicaid,8,8905,0.898,3,780,3.846,0,999,0,3,1779,1.686,11,10684,1.03,0,1744,0,0,3822,0,0,5566,0,11,16250,0.677
2015,40,St. Lawrence,Rural,Medicare,5,10362,0.483,12,3426,3.503,5,1425,3.509,17,4851,3.504,22,15213,1.446,0,5495,0,1,17970,0.056,1,23465,0.043,23,38678,0.595
2011,52,Warren,Urban,Commercial,10,9257,1.08,3,1466,2.046,0,1432,0,3,2898,1.035,13,12155,1.07,0,4953,0,0,7446,0,0,12399,0,13,24554,0.529
2014,5,Cayuga,Rural,Other,0,1204,0,0,136,0,1,107,9.346,1,243,4.115,1,1447,0.691,0,502,0,0,1411,0,0,1913,0,1,3360,0.298
2011,24,Livingston,Urban,Medicaid,6,5037,1.191,7,441,15.873,0,665,0,7,1106,6.329,13,6143,2.116,0,753,0,0,2800,0,0,3553,0,13,9696,1.341
2010,28,Nassau,Urban,Commercial,47,160702,0.292,91,37619,2.419,7,40116,0.174,98,77735,1.261,145,238437,0.608,0,70303,0,0,2337,0,0,72640,0,145,311077,0.466
2013,31,Onondaga,Urban,Medicare,31,25536,1.214,42,16369,2.566,0,5422,0,42,21791,1.927,73,47327,1.542,0,21486,0,1,32150,0.031,1,53636,0.019,74,100963,0.733
2013,43,Schoharie,Urban,Commercial,3,4654,0.645,0,283,0,0,615,0,0,898,0,3,5552,0.54,0,2140,0,0,11204,0,0,13344,0,3,18896,0.159
2011,1,Albany,Urban,Other,1,2760,0.362,0,299,0,0,167,0,0,466,0,1,3226,0.31,0,710,0,0,6807,0,0,7517,0,1,10743,0.093
2015,16,Franklin,Rural,Commercial,1,3589,0.279,0,285,0,0,537,0,0,822,0,1,4411,0.227,0,1491,0,0,7220,0,0,8711,0,1,13122,0.076
2013,4,Cattaraugus,Rural,Other,0,460,0,0,97,0,0,94,0,0,191,0,0,651,0,0,213,0,0,626,0,0,839,0,0,1490,0
2012,19,Greene,Rural,Commercial,5,5254,0.952,2,881,2.27,0,846,0,2,1727,1.158,7,6981,1.003,0,3254,0,0,3675,0,0,6929,0,7,13910,0.503
2011,40,St. Lawrence,Rural,Other,0,4256,0,0,462,0,0,273,0,0,735,0,0,4991,0,0,602,0,0,2180,0,0,2782,0,0,7773,0
2012,14,Erie,Urban,Commercial,115,115963,0.992,76,13706,5.545,5,22472,0.222,81,36178,2.239,196,152141,1.288,0,77992,0,1,121976,0.008,1,199968,0.005,197,352109,0.559
2012,9,Clinton,Rural,Commercial,4,19253,0.208,11,1842,5.972,0,2008,0,11,3850,2.857,15,23103,0.649,0,6445,0,0,13505,0,0,19950,0,15,43053,0.348
2015,26,Monroe,Urban,Other,6,5948,1.009,0,582,0,0,389,0,0,971,0,6,6919,0.867,0,2175,0,0,4004,0,0,6179,0,6,13098,0.458
2011,28,Nassau,Urban,Commercial,66,179515,0.368,86,37577,2.289,11,40134,0.274,97,77711,1.248,163,257226,0.634,0,72938,0,1,157666,0.006,1,230604,0.004,164,487830,0.336
2015,99,Unknown,Urban,Medicare,8,16123,0.496,16,6216,2.574,9,2627,3.426,25,8843,2.827,33,24966,1.322,0,19013,0,2,38208,0.052,2,57221,0.035,35,82187,0.426
2013,12,Delaware,Rural,Commercial,7,7401,0.946,2,395,5.063,0,903,0,2,1298,1.541,9,8699,1.035,0,2495,0,0,21023,0,0,23518,0,9,32217,0.279
2015,51,Ulster,Urban,Medicaid,69,23735,2.907,20,1725,11.594,1,2428,0.412,21,4153,5.057,90,27888,3.227,0,2196,0,0,5916,0,0,8112,0,90,36000,2.5
2015,35,Oswego,Urban,Medicaid,41,15437,2.656,14,1623,8.626,5,1873,2.67,19,3496,5.435,60,18933,3.169,0,3603,0,0,12498,0,0,16101,0,60,35034,1.713
2011,46,Steuben,Rural,Medicare,1,8047,0.124,3,3806,0.788,1,1679,0.596,4,5485,0.729,5,13532,0.369,0,4755,0,0,10136,0,0,14891,0,5,28423,0.176
2012,38,Rensselaer,Urban,Commercial,15,19991,0.75,4,2730,1.465,0,3006,0,4,5736,0.697,19,25727,0.739,0,11148,0,0,10401,0,0,21549,0,19,47276,0.402
2012,16,Franklin,Rural,Other,1,948,1.055,0,123,0,0,81,0,0,204,0,1,1152,0.868,0,245,0,0,165,0,0,410,0,1,1562,0.64
2011,88,Other than New York State,Urban,Medicaid,1,7531,0.133,6,1273,4.713,0,971,0,6,2244,2.674,7,9775,0.716,0,583,0,0,3087,0,0,3670,0,7,13445,0.521
2013,,Statewide Total,State,All Payers,4158,6720266,0.619,4026,1418569,2.838,437,1010098,0.433,4463,2428667,1.838,8621,9148933,0.942,3,2197583,0.001,48,10906096,0.004,51,13103679,0.004,8672,22252612,0.39
2014,9,Clinton,Rural,Other,1,953,1.049,2,145,13.793,0,81,0,2,226,8.85,3,1179,2.545,0,418,0,0,389,0,0,807,0,3,1986,1.511
2013,24,Livingston,Urban,Commercial,1,7577,0.132,0,808,0,0,1386,0,0,2194,0,1,9771,0.102,0,4516,0,0,9307,0,0,13823,0,1,23594,0.042
2012,5,Cayuga,Rural,Medicaid,5,6565,0.762,3,524,5.725,0,989,0,3,1513,1.983,8,8078,0.99,0,977,0,0,4690,0,0,5667,0,8,13745,0.582
2015,31,Onondaga,Urban,Other,9,4287,2.099,5,446,11.211,1,395,2.532,6,841,7.134,15,5128,2.925,0,1629,0,0,3641,0,0,5270,0,15,10398,1.443
2011,32,Ontario,Urban,Commercial,13,15614,0.833,4,1500,2.667,1,2634,0.38,5,4134,1.209,18,19748,0.911,0,9370,0,0,17537,0,0,26907,0,18,46655,0.386
2015,56,Wyoming,Rural,Medicare,4,2375,1.684,9,1215,7.407,0,622,0,9,1837,4.899,13,4212,3.086,1,2143,0.467,0,3777,0,1,5920,0.169,14,10132,1.382
2015,4,Cattaraugus,Rural,Other,0,388,0,0,84,0,0,72,0,0,156,0,0,544,0,0,247,0,0,566,0,0,813,0,0,1357,0
2014,12,Delaware,Rural,Other,0,479,0,0,34,0,0,48,0,0,82,0,0,561,0,0,79,0,0,641,0,0,720,0,0,1281,0
2015,34,Orleans,Urban,Medicaid,4,3560,1.124,0,303,0,0,558,0,0,861,0,4,4421,0.905,0,721,0,0,1981,0,0,2702,0,4,7123,0.562
2011,6,Chautauqua,Rural,Other,1,1630,0.613,1,139,7.194,0,154,0,1,293,3.413,2,1923,1.04,0,252,0,0,1532,0,0,1784,0,2,3707,0.54
2013,14,Erie,Urban,Medicaid,190,117651,1.615,86,11280,7.624,2,12923,0.155,88,24203,3.636,278,141854,1.96,0,13849,0,0,75192,0,0,89041,0,278,230895,1.204
2013,8,Chenango,Rural,Medicaid,2,7115,0.281,0,384,0,1,690,1.449,1,1074,0.931,3,8189,0.366,0,701,0,0,25388,0,0,26089,0,3,34278,0.088
2012,,Statewide Total,State,All Payers,3278,6849125,0.479,4061,1493599,2.719,443,1051132,0.421,4504,2544731,1.77,7782,9393856,0.828,0,2097819,0,28,10303981,0.003,28,12401800,0.002,7810,21795656,0.358
2014,58,Bronx,Urban,Other,1,13202,0.076,4,1365,2.93,0,660,0,4,2025,1.975,5,15227,0.328,0,3282,0,0,34339,0,0,37621,0,5,52848,0.095
2015,6,Chautauqua,Rural,Medicare,9,11180,0.805,13,3630,3.581,0,1121,0,13,4751,2.736,22,15931,1.381,0,4740,0,0,18863,0,0,23603,0,22,39534,0.556
2010,59,Kings (Brooklyn),Urban,Commercial,59,330427,0.179,53,39136,1.354,16,40970,0.391,69,80106,0.861,128,410533,0.312,0,83932,0,0,232,0,0,84164,0,128,494697,0.259
2013,56,Wyoming,Rural,Commercial,8,4977,1.607,1,519,1.927,0,1077,0,1,1596,0.627,9,6573,1.369,0,3235,0,0,5704,0,0,8939,0,9,15512,0.58
2014,52,Warren,Urban,Medicaid,4,5285,0.757,3,703,4.267,1,821,1.218,4,1524,2.625,8,6809,1.175,0,1257,0,0,3559,0,0,4816,0,8,11625,0.688
2014,41,Saratoga,Urban,Medicaid,21,10043,2.091,3,1453,2.065,2,1661,1.204,5,3114,1.606,26,13157,1.976,0,2808,0,1,5045,0.198,1,7853,0.127,27,21010,1.285
2015,,Statewide Total,State,All Payers,6530,6802445,0.96,4917,1346199,3.653,996,964134,1.033,5913,2310333,2.559,12443,9112778,1.365,20,2244778,0.009,166,11152249,0.015,186,13397027,0.014,12629,22509805,0.561
2012,37,Putnam,Urban,Commercial,18,16302,1.104,10,1837,5.444,1,2532,0.395,11,4369,2.518,29,20671,1.403,0,5623,0,0,9999,0,0,15622,0,29,36293,0.799
2010,58,Bronx,Urban,Commercial,36,264433,0.136,38,24706,1.538,3,19031,0.158,41,43737,0.937,77,308170,0.25,1,44668,0.022,0,352,0,1,45020,0.022,78,353190,0.221
2014,52,Warren,Urban,Commercial,3,7478,0.401,2,1019,1.963,0,1274,0,2,2293,0.872,5,9771,0.512,0,4378,0,0,7323,0,0,11701,0,5,21472,0.233
2013,60,New York (Manhattan),Urban,Commercial,72,221967,0.324,43,25071,1.715,12,34304,0.35,55,59375,0.926,127,281342,0.451,0,79834,0,0,285811,0,0,365645,0,127,646987,0.196
2012,11,Cortland,Rural,Medicare,2,4335,0.461,1,2191,0.456,1,701,1.427,2,2892,0.692,4,7227,0.553,0,1415,0,0,4243,0,0,5658,0,4,12885,0.31
2015,22,Jefferson,Urban,Medicare,10,8372,1.194,6,2466,2.433,0,1335,0,6,3801,1.579,16,12173,1.314,0,4361,0,1,10376,0.096,1,14737,0.068,17,26910,0.632
2015,32,Ontario,Urban,Medicaid,19,10357,1.835,10,726,13.774,1,1055,0.948,11,1781,6.176,30,12138,2.472,0,1928,0,0,4659,0,0,6587,0,30,18725,1.602
2011,26,Monroe,Urban,Commercial,64,90611,0.706,61,12414,4.914,3,17986,0.167,64,30400,2.105,128,121011,1.058,0,43005,0,0,85344,0,0,128349,0,128,249360,0.513
2011,33,Orange,Urban,Medicaid,26,33649,0.773,30,4321,6.943,3,6133,0.489,33,10454,3.157,59,44103,1.338,0,4454,0,0,11473,0,0,15927,0,59,60030,0.983
2015,58,Bronx,Urban,Medicaid,142,479840,0.296,368,76451,4.814,31,42453,0.73,399,118904,3.356,541,598744,0.904,0,48902,0,6,987155,0.006,6,1036057,0.006,547,1634801,0.335
2012,2,Allegany,Rural,Medicare,2,3452,0.579,1,1124,0.89,0,583,0,1,1707,0.586,3,5159,0.582,0,1679,0,0,5678,0,0,7357,0,3,12516,0.24
2014,30,Oneida,Urban,Other,5,3488,1.433,3,330,9.091,0,337,0,3,667,4.498,8,4155,1.925,0,988,0,0,2987,0,0,3975,0,8,8130,0.984
2015,53,Washington,Urban,Other,0,812,0,2,173,11.561,0,81,0,2,254,7.874,2,1066,1.876,0,277,0,0,410,0,0,687,0,2,1753,1.141
2014,14,Erie,Urban,Medicare,34,60404,0.563,93,31571,2.946,2,10113,0.198,95,41684,2.279,129,102088,1.264,0,36001,0,0,76949,0,0,112950,0,129,215038,0.6
2015,17,Fulton,Rural,Medicare,2,6799,0.294,4,2124,1.883,1,1135,0.881,5,3259,1.534,7,10058,0.696,0,3528,0,0,10791,0,0,14319,0,7,24377,0.287
2014,27,Montgomery,Rural,Medicare,6,6200,0.968,3,2194,1.367,0,1038,0,3,3232,0.928,9,9432,0.954,0,3375,0,0,18653,0,0,22028,0,9,31460,0.286
2011,33,Orange,Urban,Other,5,3047,1.641,1,589,1.698,1,371,2.695,2,960,2.083,7,4007,1.747,0,1102,0,0,2717,0,0,3819,0,7,7826,0.894
2011,53,Washington,Urban,Commercial,4,7709,0.519,7,1285,5.447,0,1249,0,7,2534,2.762,11,10243,1.074,0,4269,0,0,5656,0,0,9925,0,11,20168,0.545
2013,32,Ontario,Urban,Commercial,24,14830,1.618,15,1932,7.764,1,2628,0.381,16,4560,3.509,40,19390,2.063,0,10251,0,0,15309,0,0,25560,0,40,44950,0.89
2011,,Statewide Total,State,Medicare,364,876349,0.415,1069,688699,1.552,110,268427,0.41,1179,957126,1.232,1543,1833475,0.842,2,606683,0.003,15,2566759,0.006,17,3173442,0.005,1560,5006917,0.312
2012,44,Schuyler,Rural,Other,1,843,1.186,0,66,0,0,42,0,0,108,0,1,951,1.052,0,78,0,0,558,0,0,636,0,1,1587,0.63
2014,9,Clinton,Rural,Commercial,2,15097,0.132,3,1098,2.732,0,1331,0,3,2429,1.235,5,17526,0.285,0,5919,0,0,10032,0,0,15951,0,5,33477,0.149
2014,33,Orange,Urban,Other,3,4345,0.69,0,660,0,0,410,0,0,1070,0,3,5415,0.554,0,933,0,0,1727,0,0,2660,0,3,8075,0.372
2014,22,Jefferson,Urban,Commercial,13,16426,0.791,3,1200,2.5,1,1926,0.519,4,3126,1.28,17,19552,0.869,0,5446,0,0,8592,0,0,14038,0,17,33590,0.506
2014,2,Allegany,Rural,Commercial,5,8017,0.624,0,315,0,0,766,0,0,1081,0,5,9098,0.55,0,2087,0,0,7103,0,0,9190,0,5,18288,0.273
2012,51,Ulster,Urban,Commercial,19,25236,0.753,10,3303,3.028,1,4686,0.213,11,7989,1.377,30,33225,0.903,0,10187,0,0,15711,0,0,25898,0,30,59123,0.507
2013,23,Lewis,Rural,Commercial,0,1366,0,1,169,5.917,0,334,0,1,503,1.988,1,1869,0.535,0,1165,0,0,1356,0,0,2521,0,1,4390,0.228
2014,18,Genesee,Rural,Medicare,4,3763,1.063,5,2228,2.244,0,741,0,5,2969,1.684,9,6732,1.337,0,3089,0,0,13661,0,0,16750,0,9,23482,0.383
2011,41,Saratoga,Urban,Medicare,1,9151,0.109,10,6093,1.641,1,3351,0.298,11,9444,1.165,12,18595,0.645,0,8874,0,0,13602,0,0,22476,0,12,41071,0.292
2011,,Statewide Total,State,Commercial,1409,3080390,0.457,1058,397316,2.663,145,464883,0.312,1203,862199,1.395,2612,3942589,0.663,5,1141656,0.004,22,3235669,0.007,27,4377325,0.006,2639,8319914,0.317
2013,55,Westchester,Urban,Commercial,63,128062,0.492,39,15469,2.521,12,20876,0.575,51,36345,1.403,114,164407,0.693,0,47639,0,0,132878,0,0,180517,0,114,344924,0.331
2015,62,Richmond (Staten Island),Urban,Medicaid,84,59565,1.41,85,11169,7.61,5,5538,0.903,90,16707,5.387,174,76272,2.281,0,7017,0,1,120927,0.008,1,127944,0.008,175,204216,0.857
2015,14,Erie,Urban,Other,17,11542,1.473,4,882,4.535,5,1568,3.189,9,2450,3.673,26,13992,1.858,0,3520,0,0,7009,0,0,10529,0,26,24521,1.06
2015,7,Chemung,Urban,Medicaid,14,18372,0.762,4,1181,3.387,2,1355,1.476,6,2536,2.366,20,20908,0.957,0,1704,0,0,30581,0,0,32285,0,20,53193,0.376
2015,61,Queens,Urban,Other,3,15382,0.195,4,1910,2.094,1,1088,0.919,5,2998,1.668,8,18380,0.435,0,5976,0,0,30803,0,0,36779,0,8,55159,0.145
2012,88,Other than New York State,Urban,Other,1,6559,0.152,1,618,1.618,2,636,3.145,3,1254,2.392,4,7813,0.512,0,1098,0,0,1692,0,0,2790,0,4,10603,0.377
2013,42,Schenectady,Urban,Medicare,7,11304,0.619,5,1252,3.994,7,6088,1.15,12,7340,1.635,19,18644,1.019,1,8049,0.124,1,18212,0.055,2,26261,0.076,21,44905,0.468
2014,17,Fulton,Rural,Medicare,4,6132,0.652,5,2153,2.322,0,1007,0,5,3160,1.582,9,9292,0.969,0,3404,0,0,9520,0,0,12924,0,9,22216,0.405
2013,14,Erie,Urban,Medicare,33,55965,0.59,87,32873,2.647,4,10427,0.384,91,43300,2.102,124,99265,1.249,0,35355,0,0,73058,0,0,108413,0,124,207678,0.597
2011,35,Oswego,Urban,Other,0,1089,0,1,139,7.194,0,142,0,1,281,3.559,1,1370,0.73,0,260,0,0,609,0,0,869,0,1,2239,0.447
2015,55,Westchester,Urban,Commercial,71,113222,0.627,61,14151,4.311,11,18331,0.6,72,32482,2.217,143,145704,0.981,0,44910,0,0,154261,0,0,199171,0,143,344875,0.415
2014,99,Unknown,Urban,Commercial,56,71860,0.779,21,6518,3.222,3,7779,0.386,24,14297,1.679,80,86157,0.929,0,39583,0,1,57787,0.017,1,97370,0.01,81,183527,0.441
2011,1,Albany,Urban,Medicaid,21,33604,0.625,13,3835,3.39,1,3518,0.284,14,7353,1.904,35,40957,0.855,1,4198,0.238,0,29009,0,1,33207,0.03,36,74164,0.485
2014,32,Ontario,Urban,Commercial,31,16033,1.934,6,1943,3.088,0,2648,0,6,4591,1.307,37,20624,1.794,0,10675,0,0,16333,0,0,27008,0,37,47632,0.777
2012,62,Richmond (Staten Island),Urban,Other,3,11869,0.253,1,1149,0.87,0,401,0,1,1550,0.645,4,13419,0.298,0,856,0,0,26618,0,0,27474,0,4,40893,0.098
2015,56,Wyoming,Rural,Other,3,742,4.043,2,97,20.619,0,66,0,2,163,12.27,5,905,5.525,0,322,0,0,675,0,0,997,0,5,1902,2.629
2015,51,Ulster,Urban,Other,0,2406,0,1,285,3.509,1,127,7.874,2,412,4.854,2,2818,0.71,0,835,0,0,919,0,0,1754,0,2,4572,0.437
2012,4,Cattaraugus,Rural,Commercial,2,5279,0.379,2,559,3.578,0,1222,0,2,1781,1.123,4,7060,0.567,0,3067,0,0,8596,0,0,11663,0,4,18723,0.214
2015,46,Steuben,Rural,Commercial,7,13261,0.528,6,861,6.969,2,1856,1.078,8,2717,2.944,15,15978,0.939,0,5482,0,0,22059,0,0,27541,0,15,43519,0.345
2010,24,Livingston,Urban,Medicaid,1,3686,0.271,1,304,3.289,2,600,3.333,3,904,3.319,4,4590,0.871,0,616,0,0,59,0,0,675,0,4,5265,0.76
2015,44,Schuyler,Rural,Medicare,4,2371,1.687,2,375,5.333,0,588,0,2,963,2.077,6,3334,1.8,0,850,0,0,10664,0,0,11514,0,6,14848,0.404
2012,6,Chautauqua,Rural,Medicaid,15,21986,0.682,8,1797,4.452,1,2094,0.478,9,3891,2.313,24,25877,0.927,0,2278,0,0,21339,0,0,23617,0,24,49494,0.485
2014,24,Livingston,Urban,Medicaid,9,4480,2.009,6,478,12.552,0,685,0,6,1163,5.159,15,5643,2.658,0,1044,0,0,6458,0,0,7502,0,15,13145,1.141
2011,38,Rensselaer,Urban,Medicaid,12,15515,0.773,8,2150,3.721,0,1888,0,8,4038,1.981,20,19553,1.023,0,1994,0,0,6432,0,0,8426,0,20,27979,0.715
2013,1,Albany,Urban,Other,3,3198,0.938,1,259,3.861,0,193,0,1,452,2.212,4,3650,1.096,0,464,0,0,7056,0,0,7520,0,4,11170,0.358
2013,34,Orleans,Urban,Commercial,8,7289,1.098,7,913,7.667,0,982,0,7,1895,3.694,15,9184,1.633,0,3245,0,0,4819,0,0,8064,0,15,17248,0.87
2011,55,Westchester,Urban,Other,4,9642,0.415,4,1203,3.325,1,592,1.689,5,1795,2.786,9,11437,0.787,0,1366,0,0,15692,0,0,17058,0,9,28495,0.316
2013,29,Niagara,Urban,Medicare,12,13283,0.903,17,7879,2.158,3,3409,0.88,20,11288,1.772,32,24571,1.302,0,11142,0,0,31482,0,0,42624,0,32,67195,0.476
2010,9,Clinton,Rural,Commercial,6,19686,0.305,11,2019,5.448,0,1731,0,11,3750,2.933,17,23436,0.725,0,8951,0,0,3,0,0,8954,0,17,32390,0.525
2014,55,Westchester,Urban,Medicaid,54,95026,0.568,47,11008,4.27,13,14019,0.927,60,25027,2.397,114,120053,0.95,0,9684,0,3,154923,0.019,3,164607,0.018,117,284660,0.411
2011,51,Ulster,Urban,Commercial,15,23321,0.643,11,3303,3.33,1,4572,0.219,12,7875,1.524,27,31196,0.865,0,10328,0,0,15590,0,0,25918,0,27,57114,0.473
2014,61,Queens,Urban,Medicaid,66,332370,0.199,100,54791,1.825,22,43994,0.5,122,98785,1.235,188,431155,0.436,0,47984,0,0,792077,0,0,840061,0,188,1271216,0.148
2015,15,Essex,Rural,Medicaid,5,4980,1.004,2,235,8.511,0,266,0,2,501,3.992,7,5481,1.277,0,470,0,0,3041,0,0,3511,0,7,8992,0.778
2011,22,Jefferson,Urban,Commercial,8,19032,0.42,1,1201,0.833,0,1976,0,1,3177,0.315,9,22209,0.405,0,5752,0,0,9498,0,0,15250,0,9,37459,0.24
2015,13,Dutchess,Urban,Medicaid,67,18001,3.722,19,2490,7.631,0,2582,0,19,5072,3.746,86,23073,3.727,0,2775,0,0,9270,0,0,12045,0,86,35118,2.449
2014,43,Schoharie,Urban,Medicaid,2,3341,0.599,2,187,10.695,5,382,13.089,7,569,12.302,9,3910,2.302,0,544,0,0,6563,0,0,7107,0,9,11017,0.817
2014,44,Schuyler,Rural,Commercial,1,3006,0.333,0,212,0,0,376,0,0,588,0,1,3594,0.278,0,1056,0,0,8101,0,0,9157,0,1,12751,0.078
2013,61,Queens,Urban,Commercial,59,307705,0.192,56,31811,1.76,10,38887,0.257,66,70698,0.934,125,378403,0.33,0,73755,0,0,491491,0,0,565246,0,125,943649,0.132
2011,18,Genesee,Rural,Other,0,738,0,0,81,0,0,44,0,0,125,0,0,863,0,0,97,0,0,376,0,0,473,0,0,1336,0
2013,10,Columbia,Rural,Medicaid,4,5960,0.671,0,560,0,0,718,0,0,1278,0,4,7238,0.553,0,864,0,0,2749,0,0,3613,0,4,10851,0.369
2011,35,Oswego,Urban,Medicare,5,4705,1.063,10,4369,2.289,1,1766,0.566,11,6135,1.793,16,10840,1.476,0,4523,0,0,5044,0,0,9567,0,16,20407,0.784
2012,4,Cattaraugus,Rural,Medicaid,4,3117,1.283,2,401,4.988,1,501,1.996,3,902,3.326,7,4019,1.742,0,833,0,0,3689,0,0,4522,0,7,8541,0.82
2012,47,Suffolk,Urban,Medicare,27,64755,0.417,111,60365,1.839,1,15944,0.063,112,76309,1.468,139,141064,0.985,0,47443,0,1,66378,0.015,1,113821,0.009,140,254885,0.549
2015,35,Oswego,Urban,Commercial,13,11140,1.167,7,1449,4.831,1,2401,0.416,8,3850,2.078,21,14990,1.401,0,9922,0,0,7894,0,0,17816,0,21,32806,0.64
2011,10,Columbia,Rural,Medicare,1,3839,0.26,4,2705,1.479,1,864,1.157,5,3569,1.401,6,7408,0.81,0,2287,0,0,5702,0,0,7989,0,6,15397,0.39
2013,26,Monroe,Urban,Medicare,30,43516,0.689,59,26570,2.221,6,7078,0.848,65,33648,1.932,95,77164,1.231,0,28691,0,0,76968,0,0,105659,0,95,182823,0.52
2015,20,Hamilton,Rural,Medicare,0,353,0,0,169,0,0,100,0,0,269,0,0,622,0,0,404,0,0,733,0,0,1137,0,0,1759,0
2014,10,Columbia,Rural,Medicaid,11,6626,1.66,1,665,1.504,0,715,0,1,1380,0.725,12,8006,1.499,0,1094,0,0,2734,0,0,3828,0,12,11834,1.014
2012,41,Saratoga,Urban,Medicare,2,10153,0.197,5,5511,0.907,0,2997,0,5,8508,0.588,7,18661,0.375,0,10551,0,0,14212,0,0,24763,0,7,43424,0.161
2011,16,Franklin,Rural,Medicare,0,3463,0,4,1876,2.132,0,497,0,4,2373,1.686,4,5836,0.685,1,1574,0.635,0,5050,0,1,6624,0.151,5,12460,0.401
2013,28,Nassau,Urban,Other,1,10118,0.099,1,1522,0.657,0,478,0,1,2000,0.5,2,12118,0.165,0,3137,0,0,5113,0,0,8250,0,2,20368,0.098
2011,13,Dutchess,Urban,Medicare,8,14948,0.535,16,9787,1.635,0,4310,0,16,14097,1.135,24,29045,0.826,0,8327,0,0,17544,0,0,25871,0,24,54916,0.437
2012,26,Monroe,Urban,Other,1,6182,0.162,3,709,4.231,0,365,0,3,1074,2.793,4,7256,0.551,0,1035,0,0,4079,0,0,5114,0,4,12370,0.323
2012,99,Unknown,Urban,Commercial,54,114401,0.472,36,8475,4.248,1,10350,0.097,37,18825,1.965,91,133226,0.683,0,54894,0,0,71625,0,0,126519,0,91,259745,0.35
2012,50,Tompkins,Urban,Commercial,2,12118,0.165,2,1117,1.791,0,1971,0,2,3088,0.648,4,15206,0.263,0,5433,0,0,9254,0,0,14687,0,4,29893,0.134
2012,55,Westchester,Urban,Commercial,54,132538,0.407,39,16578,2.353,12,21139,0.568,51,37717,1.352,105,170255,0.617,0,46854,0,0,116120,0,0,162974,0,105,333229,0.315
2014,56,Wyoming,Rural,Medicaid,7,3324,2.106,1,248,4.032,0,336,0,1,584,1.712,8,3908,2.047,0,658,0,0,1482,0,0,2140,0,8,6048,1.323
2014,25,Madison,Urban,Other,1,672,1.488,0,53,0,0,64,0,0,117,0,1,789,1.267,0,146,0,0,314,0,0,460,0,1,1249,0.801
2014,21,Herkimer,Urban,Other,0,639,0,0,38,0,0,81,0,0,119,0,0,758,0,0,89,0,0,655,0,0,744,0,0,1502,0
2011,37,Putnam,Urban,Medicare,4,3693,1.083,4,2886,1.386,0,1080,0,4,3966,1.009,8,7659,1.045,0,2473,0,0,4034,0,0,6507,0,8,14166,0.565
2015,38,Rensselaer,Urban,Commercial,28,19036,1.471,5,2079,2.405,1,3105,0.322,6,5184,1.157,34,24220,1.404,0,12039,0,1,28078,0.036,1,40117,0.025,35,64337,0.544
2015,37,Putnam,Urban,Other,0,946,0,0,70,0,0,28,0,0,98,0,0,1044,0,0,416,0,0,358,0,0,774,0,0,1818,0
2012,42,Schenectady,Urban,Commercial,12,29223,0.411,1,1005,0.995,3,5193,0.578,4,6198,0.645,16,35421,0.452,0,13385,0,0,17778,0,0,31163,0,16,66584,0.24
2015,23,Lewis,Rural,Medicare,0,1932,0,1,586,1.706,1,419,2.387,2,1005,1.99,2,2937,0.681,1,1036,0.965,0,2606,0,1,3642,0.275,3,6579,0.456
2015,41,Saratoga,Urban,Medicare,13,9209,1.412,5,4839,1.033,2,3398,0.589,7,8237,0.85,20,17446,1.146,0,10893,0,0,28132,0,0,39025,0,20,56471,0.354
2012,33,Orange,Urban,Commercial,65,58457,1.112,29,6863,4.226,2,9474,0.211,31,16337,1.898,96,74794,1.284,0,21525,0,0,24411,0,0,45936,0,96,120730,0.795
2015,25,Madison,Urban,Commercial,10,8593,1.164,5,705,7.092,2,1320,1.515,7,2025,3.457,17,10618,1.601,0,5582,0,0,4023,0,0,9605,0,17,20223,0.841
2014,13,Dutchess,Urban,Other,1,3916,0.255,0,593,0,0,272,0,0,865,0,1,4781,0.209,0,2183,0,0,1592,0,0,3775,0,1,8556,0.117
2012,60,New York (Manhattan),Urban,Other,1,9484,0.105,5,1139,4.39,0,625,0,5,1764,2.834,6,11248,0.533,0,4072,0,0,10966,0,0,15038,0,6,26286,0.228
2011,54,Wayne,Urban,Other,0,831,0,0,88,0,0,80,0,0,168,0,0,999,0,0,201,0,0,614,0,0,815,0,0,1814,0
2013,19,Greene,Rural,Medicaid,7,3707,1.888,16,568,28.169,0,645,0,16,1213,13.19,23,4920,4.675,0,785,0,0,1974,0,0,2759,0,23,7679,2.995
2014,3,Broome,Urban,Other,2,1348,1.484,2,153,13.072,0,103,0,2,256,7.813,4,1604,2.494,0,201,0,0,1918,0,0,2119,0,4,3723,1.074
2013,55,Westchester,Urban,Medicaid,24,80514,0.298,40,11271,3.549,9,13306,0.676,49,24577,1.994,73,105091,0.695,0,8107,0,1,135445,0.007,1,143552,0.007,74,248643,0.298
2014,56,Wyoming,Rural,Medicare,4,2237,1.788,1,1233,0.811,1,674,1.484,2,1907,1.049,6,4144,1.448,0,2010,0,0,3117,0,0,5127,0,6,9271,0.647
2013,45,Seneca,Rural,Other,0,490,0,2,67,29.851,0,39,0,2,106,18.868,2,596,3.356,0,236,0,0,470,0,0,706,0,2,1302,1.536
2012,25,Madison,Urban,Medicaid,6,8272,0.725,6,498,12.048,1,861,1.161,7,1359,5.151,13,9631,1.35,0,961,0,0,2546,0,0,3507,0,13,13138,0.989
2015,51,Ulster,Urban,Commercial,30,24963,1.202,11,2620,4.198,4,4038,0.991,15,6658,2.253,45,31621,1.423,0,8849,0,0,14407,0,0,23256,0,45,54877,0.82
2015,21,Herkimer,Urban,Medicaid,9,7468,1.205,8,670,11.94,4,1004,3.984,12,1674,7.168,21,9142,2.297,1,1423,0.703,0,25971,0,1,27394,0.037,22,36536,0.602
2013,62,Richmond (Staten Island),Urban,Medicaid,60,60772,0.987,100,11751,8.51,4,6867,0.582,104,18618,5.586,164,79390,2.066,0,6568,0,1,127482,0.008,1,134050,0.007,165,213440,0.773
2012,47,Suffolk,Urban,Commercial,285,271100,1.051,177,46645,3.795,10,39433,0.254,187,86078,2.172,472,357178,1.321,0,98630,0,5,105671,0.047,5,204301,0.024,477,561479,0.85
2012,14,Erie,Urban,Medicaid,98,117497,0.834,98,12429,7.885,6,12896,0.465,104,25325,4.107,202,142822,1.414,0,13169,0,0,82131,0,0,95300,0,202,238122,0.848
2012,61,Queens,Urban,Medicare,9,68256,0.132,73,68076,1.072,8,23055,0.347,81,91131,0.889,90,159387,0.565,0,35809,0,0,253094,0,0,288903,0,90,448290,0.201
2015,60,New York (Manhattan),Urban,Commercial,59,205278,0.287,78,20455,3.813,27,33681,0.802,105,54136,1.94,164,259414,0.632,1,80732,0.012,8,270435,0.03,9,351167,0.026,173,610581,0.283
2012,12,Delaware,Rural,Medicaid,0,6415,0,3,255,11.765,5,583,8.576,8,838,9.547,8,7253,1.103,0,558,0,0,12615,0,0,13173,0,8,20426,0.392
2014,52,Warren,Urban,Other,0,624,0,0,60,0,0,36,0,0,96,0,0,720,0,0,142,0,0,313,0,0,455,0,0,1175,0
2011,88,Other than New York State,Urban,Other,1,6063,0.165,3,586,5.119,1,603,1.658,4,1189,3.364,5,7252,0.689,0,664,0,0,1467,0,0,2131,0,5,9383,0.533
2012,61,Queens,Urban,Medicaid,54,285042,0.189,102,53280,1.914,18,38329,0.47,120,91609,1.31,174,376651,0.462,0,32986,0,0,769833,0,0,802819,0,174,1179470,0.148
2010,38,Rensselaer,Urban,Other,1,1084,0.923,0,156,0,0,110,0,0,266,0,1,1350,0.741,1,254,3.937,0,0,0,1,254,3.937,2,1604,1.247
2012,53,Washington,Urban,Commercial,4,7468,0.536,4,1043,3.835,0,1131,0,4,2174,1.84,8,9642,0.83,0,4056,0,0,5156,0,0,9212,0,8,18854,0.424
2014,34,Orleans,Urban,Medicare,5,2318,2.157,7,1278,5.477,0,645,0,7,1923,3.64,12,4241,2.83,0,1786,0,0,3406,0,0,5192,0,12,9433,1.272
2014,11,Cortland,Rural,Commercial,6,7645,0.785,2,591,3.384,1,888,1.126,3,1479,2.028,9,9124,0.986,0,3138,0,0,4311,0,0,7449,0,9,16573,0.543
2015,22,Jefferson,Urban,Commercial,16,14117,1.133,8,1024,7.813,1,1784,0.561,9,2808,3.205,25,16925,1.477,0,5569,0,0,9030,0,0,14599,0,25,31524,0.793
2014,4,Cattaraugus,Rural,Commercial,4,4310,0.928,2,485,4.124,1,1077,0.929,3,1562,1.921,7,5872,1.192,0,2958,0,1,8000,0.125,1,10958,0.091,8,16830,0.475
2015,59,Kings (Brooklyn),Urban,Medicaid,179,431829,0.415,218,71319,3.057,49,60880,0.805,267,132199,2.02,446,564028,0.791,0,60956,0,1,962507,0.001,1,1023463,0.001,447,1587491,0.282
2011,62,Richmond (Staten Island),Urban,Other,9,9412,0.956,4,1033,3.872,0,451,0,4,1484,2.695,13,10896,1.193,0,733,0,0,32113,0,0,32846,0,13,43742,0.297
2015,61,Queens,Urban,Commercial,90,312099,0.288,77,33663,2.287,22,39339,0.559,99,73002,1.356,189,385101,0.491,0,74197,0,1,623710,0.002,1,697907,0.001,190,1083008,0.175
2011,24,Livingston,Urban,Commercial,7,10612,0.66,6,969,6.192,0,1555,0,6,2524,2.377,13,13136,0.99,0,4295,0,0,7544,0,0,11839,0,13,24975,0.521
2011,3,Broome,Urban,Medicare,8,14913,0.536,12,8238,1.457,0,2738,0,12,10976,1.093,20,25889,0.773,0,7590,0,0,37729,0,0,45319,0,20,71208,0.281
2015,53,Washington,Urban,Commercial,6,5980,1.003,3,796,3.769,1,956,1.046,4,1752,2.283,10,7732,1.293,0,3584,0,0,5790,0,0,9374,0,10,17106,0.585
2011,17,Fulton,Rural,Medicaid,0,3040,0,9,932,9.657,2,1110,1.802,11,2042,5.387,11,5082,2.165,0,1505,0,0,5645,0,0,7150,0,11,12232,0.899
2011,34,Orleans,Urban,Medicare,1,2157,0.464,3,1535,1.954,0,756,0,3,2291,1.309,4,4448,0.899,0,1891,0,0,2838,0,0,4729,0,4,9177,0.436
2015,45,Seneca,Rural,Medicare,0,2505,0,2,1321,1.514,1,486,2.058,3,1807,1.66,3,4312,0.696,0,1777,0,0,4763,0,0,6540,0,3,10852,0.276
2011,10,Columbia,Rural,Medicaid,4,5744,0.696,6,606,9.901,1,637,1.57,7,1243,5.632,11,6987,1.574,0,707,0,0,2340,0,0,3047,0,11,10034,1.096
2014,1,Albany,Urban,Other,3,2218,1.353,1,215,4.651,1,129,7.752,2,344,5.814,5,2562,1.952,0,511,0,0,3506,0,0,4017,0,5,6579,0.76
2011,22,Jefferson,Urban,Medicaid,5,14223,0.352,7,877,7.982,0,1667,0,7,2544,2.752,12,16767,0.716,0,1396,0,0,5212,0,0,6608,0,12,23375,0.513
2014,57,Yates,Urban,Commercial,4,3366,1.188,0,234,0,0,479,0,0,713,0,4,4079,0.981,0,1872,0,0,3857,0,0,5729,0,4,9808,0.408
2013,58,Bronx,Urban,Medicaid,111,434944,0.255,295,73939,3.99,17,40751,0.417,312,114690,2.72,423,549634,0.77,0,43822,0,3,951103,0.003,3,994925,0.003,426,1544559,0.276
2015,36,Otsego,Rural,Commercial,6,9259,0.648,6,698,8.596,0,1225,0,6,1923,3.12,12,11182,1.073,0,3941,0,0,28733,0,0,32674,0,12,43856,0.274
2013,7,Chemung,Urban,Medicaid,5,8962,0.558,1,748,1.337,0,993,0,1,1741,0.574,6,10703,0.561,0,824,0,0,10965,0,0,11789,0,6,22492,0.267
2013,30,Oneida,Urban,Medicaid,39,32404,1.204,33,3500,9.429,3,4001,0.75,36,7501,4.799,75,39905,1.879,0,5123,0,3,20970,0.143,3,26093,0.115,78,65998,1.182
2015,37,Putnam,Urban,Medicaid,12,5027,2.387,9,653,13.783,1,717,1.395,10,1370,7.299,22,6397,3.439,0,875,0,0,3296,0,0,4171,0,22,10568,2.082
2011,31,Onondaga,Urban,Other,0,4272,0,5,512,9.766,1,430,2.326,6,942,6.369,6,5214,1.151,0,935,0,0,3552,0,0,4487,0,6,9701,0.618
2011,23,Lewis,Rural,Medicare,0,1494,0,0,484,0,1,437,2.288,1,921,1.086,1,2415,0.414,0,812,0,0,2639,0,0,3451,0,1,5866,0.17
2013,3,Broome,Urban,Medicare,14,13430,1.042,15,7719,1.943,0,2553,0,15,10272,1.46,29,23702,1.224,0,5728,0,1,101525,0.01,1,107253,0.009,30,130955,0.229
2014,54,Wayne,Urban,Other,0,734,0,0,150,0,0,110,0,0,260,0,0,994,0,0,539,0,0,443,0,0,982,0,0,1976,0
2013,6,Chautauqua,Rural,Commercial,40,21146,1.892,4,1516,2.639,0,2198,0,4,3714,1.077,44,24860,1.77,0,7642,0,0,24510,0,0,32152,0,44,57012,0.772
2011,46,Steuben,Rural,Other,0,1588,0,1,157,6.369,0,123,0,1,280,3.571,1,1868,0.535,0,566,0,0,730,0,0,1296,0,1,3164,0.316
2014,36,Otsego,Rural,Medicare,2,5053,0.396,1,2159,0.463,3,1057,2.838,4,3216,1.244,6,8269,0.726,0,3113,0,0,63759,0,0,66872,0,6,75141,0.08
2012,39,Rockland,Urban,Commercial,21,37224,0.564,11,4946,2.224,4,6713,0.596,15,11659,1.287,36,48883,0.736,0,8664,0,0,23917,0,0,32581,0,36,81464,0.442
2013,13,Dutchess,Urban,Medicaid,44,17076,2.577,20,1739,11.501,0,2324,0,20,4063,4.922,64,21139,3.028,0,2032,0,0,6516,0,0,8548,0,64,29687,2.156
2010,9,Clinton,Rural,Medicaid,4,8443,0.474,4,758,5.277,0,1007,0,4,1765,2.266,8,10208,0.784,0,1551,0,0,0,0,0,1551,0,8,11759,0.68
2012,24,Livingston,Urban,Commercial,5,9038,0.553,5,848,5.896,0,1390,0,5,2238,2.234,10,11276,0.887,0,4308,0,0,8412,0,0,12720,0,10,23996,0.417
2012,42,Schenectady,Urban,Other,1,1218,0.821,0,100,0,0,397,0,0,497,0,1,1715,0.583,0,329,0,0,1350,0,0,1679,0,1,3394,0.295
2012,50,Tompkins,Urban,Medicare,4,4912,0.814,7,1959,3.573,0,730,0,7,2689,2.603,11,7601,1.447,0,2646,0,0,8234,0,0,10880,0,11,18481,0.595
2011,58,Bronx,Urban,Medicare,16,65035,0.246,88,54266,1.622,4,14052,0.285,92,68318,1.347,108,133353,0.81,0,27066,0,0,298407,0,0,325473,0,108,458826,0.235
2015,10,Columbia,Rural,Medicare,3,4605,0.651,4,2851,1.403,1,836,1.196,5,3687,1.356,8,8292,0.965,0,3154,0,0,7045,0,0,10199,0,8,18491,0.433
2015,1,Albany,Urban,Commercial,37,36091,1.025,14,3930,3.562,4,5926,0.675,18,9856,1.826,55,45947,1.197,0,21725,0,0,61123,0,0,82848,0,55,128795,0.427
2011,24,Livingston,Urban,Medicare,1,3459,0.289,10,1950,5.128,0,856,0,10,2806,3.564,11,6265,1.756,0,2675,0,0,6178,0,0,8853,0,11,15118,0.728
2014,6,Chautauqua,Rural,Medicaid,26,22960,1.132,9,1684,5.344,0,2252,0,9,3936,2.287,35,26896,1.301,0,2875,0,1,16217,0.062,1,19092,0.052,36,45988,0.783
2013,18,Genesee,Rural,Medicare,4,3457,1.157,4,2281,1.754,0,763,0,4,3044,1.314,8,6501,1.231,0,3045,0,0,13985,0,0,17030,0,8,23531,0.34
2014,22,Jefferson,Urban,Medicaid,10,16008,0.625,3,904,3.319,1,1321,0.757,4,2225,1.798,14,18233,0.768,0,1721,0,0,5421,0,0,7142,0,14,25375,0.552
2014,25,Madison,Urban,Commercial,24,8775,2.735,2,812,2.463,1,1430,0.699,3,2242,1.338,27,11017,2.451,0,5518,0,0,4181,0,0,9699,0,27,20716,1.303
2015,44,Schuyler,Rural,Commercial,2,3014,0.664,1,204,4.902,0,336,0,1,540,1.852,3,3554,0.844,0,960,0,0,7236,0,0,8196,0,3,11750,0.255
2011,15,Essex,Rural,Medicare,1,2621,0.382,2,1024,1.953,0,654,0,2,1678,1.192,3,4299,0.698,0,1725,0,0,6222,0,0,7947,0,3,12246,0.245
2013,62,Richmond (Staten Island),Urban,Commercial,25,58944,0.424,35,10368,3.376,1,9093,0.11,36,19461,1.85,61,78405,0.778,0,20572,0,1,75920,0.013,1,96492,0.01,62,174897,0.354
2010,6,Chautauqua,Rural,Commercial,15,28334,0.529,7,2031,3.447,1,2721,0.368,8,4752,1.684,23,33086,0.695,0,10415,0,0,4,0,0,10419,0,23,43505,0.529
2011,39,Rockland,Urban,Medicare,6,10817,0.555,6,10105,0.594,1,4076,0.245,7,14181,0.494,13,24998,0.52,0,4952,0,0,22297,0,0,27249,0,13,52247,0.249
2013,58,Bronx,Urban,Commercial,64,283688,0.226,52,25141,2.068,3,17577,0.171,55,42718,1.288,119,326406,0.365,0,47824,0,0,312675,0,0,360499,0,119,686905,0.173
2015,37,Putnam,Urban,Commercial,24,13094,1.833,6,1519,3.95,3,2175,1.379,9,3694,2.436,33,16788,1.966,1,6034,0.166,0,10621,0,1,16655,0.06,34,33443,1.017
2012,36,Otsego,Rural,Medicare,0,4687,0,8,2179,3.671,4,1001,3.996,12,3180,3.774,12,7867,1.525,0,2405,0,0,39881,0,0,42286,0,12,50153,0.239
2012,56,Wyoming,Rural,Medicare,2,2096,0.954,2,1296,1.543,0,722,0,2,2018,0.991,4,4114,0.972,0,1976,0,0,2472,0,0,4448,0,4,8562,0.467
2014,29,Niagara,Urban,Medicaid,30,24625,1.218,13,2856,4.552,1,2674,0.374,14,5530,2.532,44,30155,1.459,0,3603,0,0,15213,0,0,18816,0,44,48971,0.898
2012,34,Orleans,Urban,Commercial,6,8838,0.679,2,980,2.041,0,1141,0,2,2121,0.943,8,10959,0.73,0,3353,0,0,5079,0,0,8432,0,8,19391,0.413
2015,99,Unknown,Urban,Medicaid,34,30655,1.109,20,4053,4.935,6,2258,2.657,26,6311,4.12,60,36966,1.623,0,15926,0,0,36371,0,0,52297,0,60,89263,0.672
2013,51,Ulster,Urban,Commercial,45,25385,1.773,15,2886,5.198,0,4288,0,15,7174,2.091,60,32559,1.843,0,9794,0,0,14837,0,0,24631,0,60,57190,1.049
2015,48,Sullivan,Rural,Commercial,30,18559,1.616,9,1520,5.921,2,1670,1.198,11,3190,3.448,41,21749,1.885,0,4795,0,2,9843,0.203,2,14638,0.137,43,36387,1.182
2011,25,Madison,Urban,Commercial,4,10432,0.383,4,934,4.283,1,1709,0.585,5,2643,1.892,9,13075,0.688,0,5665,0,0,10656,0,0,16321,0,9,29396,0.306
2011,60,New York (Manhattan),Urban,Medicare,27,55782,0.484,89,46056,1.932,16,21119,0.758,105,67175,1.563,132,122957,1.074,0,44059,0,3,323746,0.009,3,367805,0.008,135,490762,0.275
2013,,Statewide Total,State,Commercial,2005,2934845,0.683,1094,340497,3.213,119,426386,0.279,1213,766883,1.582,3218,3701728,0.869,1,1116839,0.001,14,3327273,0.004,15,4444112,0.003,3233,8145840,0.397
2015,31,Onondaga,Urban,Medicare,34,28597,1.189,52,16673,3.119,11,5093,2.16,63,21766,2.894,97,50363,1.926,0,24087,0,1,51348,0.019,1,75435,0.013,98,125798,0.779
2013,31,Onondaga,Urban,Other,5,4222,1.184,3,504,5.952,1,398,2.513,4,902,4.435,9,5124,1.756,0,1125,0,0,2820,0,0,3945,0,9,9069,0.992
2014,2,Allegany,Rural,Other,0,533,0,0,49,0,0,50,0,0,99,0,0,632,0,0,138,0,0,853,0,0,991,0,0,1623,0
2015,52,Warren,Urban,Commercial,7,6113,1.145,3,857,3.501,1,1110,0.901,4,1967,2.034,11,8080,1.361,0,4585,0,0,7408,0,0,11993,0,11,20073,0.548
2015,34,Orleans,Urban,Commercial,9,5027,1.79,5,649,7.704,1,897,1.115,6,1546,3.881,15,6573,2.282,0,2394,0,0,5026,0,0,7420,0,15,13993,1.072
2013,34,Orleans,Urban,Medicare,2,2216,0.903,4,1371,2.918,0,660,0,4,2031,1.969,6,4247,1.413,0,2008,0,0,3169,0,0,5177,0,6,9424,0.637
2015,15,Essex,Rural,Commercial,3,6495,0.462,1,300,3.333,2,508,3.937,3,808,3.713,6,7303,0.822,0,1878,0,0,7813,0,0,9691,0,6,16994,0.353
2011,56,Wyoming,Rural,Medicare,1,2027,0.493,6,1219,4.922,1,688,1.453,7,1907,3.671,8,3934,2.034,0,1821,0,0,3032,0,0,4853,0,8,8787,0.91
2015,16,Franklin,Rural,Other,1,898,1.114,2,96,20.833,0,93,0,2,189,10.582,3,1087,2.76,0,226,0,0,616,0,0,842,0,3,1929,1.555
2012,56,Wyoming,Rural,Medicaid,2,3379,0.592,1,240,4.167,0,392,0,1,632,1.582,3,4011,0.748,0,640,0,0,1513,0,0,2153,0,3,6164,0.487
2011,47,Suffolk,Urban,Commercial,227,270555,0.839,195,48623,4.01,9,42610,0.211,204,91233,2.236,431,361788,1.191,0,94917,0,3,108536,0.028,3,203453,0.015,434,565241,0.768
2015,47,Suffolk,Urban,Medicaid,355,119924,2.96,126,20376,6.184,26,18562,1.401,152,38938,3.904,507,158862,3.191,0,19605,0,8,75569,0.106,8,95174,0.084,515,254036,2.027
2015,49,Tioga,Urban,Medicare,0,1190,0,1,658,1.52,0,293,0,1,951,1.052,1,2141,0.467,0,1183,0,0,3504,0,0,4687,0,1,6828,0.146
2015,46,Steuben,Rural,Medicare,7,9452,0.741,6,3032,1.979,2,1386,1.443,8,4418,1.811,15,13870,1.081,1,4879,0.205,0,25189,0,1,30068,0.033,16,43938,0.364
2010,55,Westchester,Urban,Medicare,5,22126,0.226,22,25132,0.875,1,11682,0.086,23,36814,0.625,28,58940,0.475,0,17711,0,0,21,0,0,17732,0,28,76672,0.365
2015,26,Monroe,Urban,Medicaid,143,106651,1.341,75,9931,7.552,3,9472,0.317,78,19403,4.02,221,126054,1.753,0,14496,0,0,78210,0,0,92706,0,221,218760,1.01
2011,13,Dutchess,Urban,Unknown,0,923,0,0,32,0,0,21,0,0,53,0,0,976,0,0,374,0,0,159,0,0,533,0,0,1509,0
2011,42,Schenectady,Urban,Medicare,3,11887,0.252,2,1129,1.771,10,6884,1.453,12,8013,1.498,15,19900,0.754,0,6855,0,1,17332,0.058,1,24187,0.041,16,44087,0.363
2015,55,Westchester,Urban,Other,2,9520,0.21,2,871,2.296,0,525,0,2,1396,1.433,4,10916,0.366,0,1927,0,0,8623,0,0,10550,0,4,21466,0.186
2011,58,Bronx,Urban,Medicaid,88,411854,0.214,232,69478,3.339,58,50892,1.14,290,120370,2.409,378,532224,0.71,0,44614,0,4,993224,0.004,4,1037838,0.004,382,1570062,0.243
2014,88,Other than New York State,Urban,Other,4,6254,0.64,1,599,1.669,1,619,1.616,2,1218,1.642,6,7472,0.803,0,1338,0,0,3305,0,0,4643,0,6,12115,0.495
2014,53,Washington,Urban,Medicare,5,4050,1.235,3,2301,1.304,0,746,0,3,3047,0.985,8,7097,1.127,0,3285,0,0,7655,0,0,10940,0,8,18037,0.444
2015,25,Madison,Urban,Medicare,2,4858,0.412,4,1779,2.248,1,1087,0.92,5,2866,1.745,7,7724,0.906,0,3772,0,0,7408,0,0,11180,0,7,18904,0.37
2013,49,Tioga,Urban,Commercial,3,3793,0.791,2,516,3.876,0,805,0,2,1321,1.514,5,5114,0.978,0,2168,0,0,8833,0,0,11001,0,5,16115,0.31
2015,6,Chautauqua,Rural,Medicaid,49,21984,2.229,10,1673,5.977,1,2031,0.492,11,3704,2.97,60,25688,2.336,0,3025,0,0,15419,0,0,18444,0,60,44132,1.36
2015,52,Warren,Urban,Medicaid,8,5792,1.381,1,841,1.189,1,851,1.175,2,1692,1.182,10,7484,1.336,0,1450,0,0,3753,0,0,5203,0,10,12687,0.788
2014,34,Orleans,Urban,Other,0,594,0,1,75,13.333,0,48,0,1,123,8.13,1,717,1.395,0,255,0,0,621,0,0,876,0,1,1593,0.628
2014,8,Chenango,Rural,Other,0,503,0,1,50,20,0,49,0,1,99,10.101,1,602,1.661,0,81,0,0,498,0,0,579,0,1,1181,0.847
2013,55,Westchester,Urban,Medicare,14,40524,0.345,48,31057,1.546,7,12741,0.549,55,43798,1.256,69,84322,0.818,0,27189,0,0,105681,0,0,132870,0,69,217192,0.318
2011,51,Ulster,Urban,Medicaid,11,15584,0.706,9,1749,5.146,1,2559,0.391,10,4308,2.321,21,19892,1.056,0,1612,0,0,4670,0,0,6282,0,21,26174,0.802
2013,11,Cortland,Rural,Medicaid,8,8874,0.902,7,467,14.989,1,676,1.479,8,1143,6.999,16,10017,1.597,0,877,0,0,2535,0,0,3412,0,16,13429,1.191
2012,22,Jefferson,Urban,Medicaid,5,13769,0.363,4,884,4.525,0,1420,0,4,2304,1.736,9,16073,0.56,0,1289,0,0,4998,0,0,6287,0,9,22360,0.403
2014,26,Monroe,Urban,Medicaid,165,96712,1.706,94,9723,9.668,4,9896,0.404,98,19619,4.995,263,116331,2.261,0,12836,0,0,77268,0,0,90104,0,263,206435,1.274
2011,12,Delaware,Rural,Commercial,6,8315,0.722,2,527,3.795,4,906,4.415,6,1433,4.187,12,9748,1.231,0,3629,0,1,25595,0.039,1,29224,0.034,13,38972,0.334
2012,29,Niagara,Urban,Medicaid,24,23033,1.042,21,3080,6.818,0,2655,0,21,5735,3.662,45,28768,1.564,0,3103,0,0,14325,0,0,17428,0,45,46196,0.974
2012,49,Tioga,Urban,Medicare,0,1349,0,1,909,1.1,0,377,0,1,1286,0.778,1,2635,0.38,0,958,0,0,8176,0,0,9134,0,1,11769,0.085
2010,28,Nassau,Urban,Medicaid,24,47595,0.504,54,13743,3.929,3,8608,0.349,57,22351,2.55,81,69946,1.158,0,6523,0,0,2717,0,0,9240,0,81,79186,1.023
2015,54,Wayne,Urban,Other,0,790,0,3,176,17.045,0,136,0,3,312,9.615,3,1102,2.722,0,317,0,0,529,0,0,846,0,3,1948,1.54
2015,38,Rensselaer,Urban,Medicare,8,10850,0.737,16,5286,3.027,3,1837,1.633,19,7123,2.667,27,17973,1.502,0,7437,0,0,24830,0,0,32267,0,27,50240,0.537
2015,26,Monroe,Urban,Commercial,106,83194,1.274,46,9634,4.775,5,14299,0.35,51,23933,2.131,157,107127,1.466,0,47366,0,1,86797,0.012,1,134163,0.007,158,241290,0.655
2012,31,Onondaga,Urban,Medicaid,68,48602,1.399,30,6098,4.92,0,6922,0,30,13020,2.304,98,61622,1.59,0,5169,0,0,32836,0,0,38005,0,98,99627,0.984
2011,28,Nassau,Urban,Other,1,9876,0.101,4,1472,2.717,0,489,0,4,1961,2.04,5,11837,0.422,0,2190,0,0,7325,0,0,9515,0,5,21352,0.234
2015,4,Cattaraugus,Rural,Commercial,9,4088,2.202,1,479,2.088,1,1053,0.95,2,1532,1.305,11,5620,1.957,0,2939,0,0,8614,0,0,11553,0,11,17173,0.641
2014,62,Richmond (Staten Island),Urban,Other,8,11189,0.715,3,796,3.769,0,318,0,3,1114,2.693,11,12303,0.894,0,960,0,0,24329,0,0,25289,0,11,37592,0.293
2014,21,Herkimer,Urban,Medicare,5,5075,0.985,1,1889,0.529,2,1633,1.225,3,3522,0.852,8,8597,0.931,0,2974,0,0,22229,0,0,25203,0,8,33800,0.237
2015,,Statewide Total,State,Medicaid,3112,2822242,1.103,1971,384536,5.126,290,321301,0.903,2261,705837,3.203,5373,3528079,1.523,4,381021,0.01,55,4419620,0.012,59,4800641,0.012,5432,8328720,0.652
2013,61,Queens,Urban,Medicare,5,71374,0.07,64,63029,1.015,8,23282,0.344,72,86311,0.834,77,157685,0.488,0,43589,0,0,251757,0,0,295346,0,77,453031,0.17
2014,31,Onondaga,Urban,Medicare,20,26060,0.767,32,16156,1.981,1,5181,0.193,33,21337,1.547,53,47397,1.118,0,23511,0,0,37649,0,0,61160,0,53,108557,0.488
2010,88,Other than New York State,Urban,Medicaid,5,6154,0.812,6,1292,4.644,0,999,0,6,2291,2.619,11,8445,1.303,0,578,0,0,9,0,0,587,0,11,9032,1.218
2014,30,Oneida,Urban,Commercial,14,22975,0.609,10,2356,4.244,0,4251,0,10,6607,1.514,24,29582,0.811,0,16683,0,1,21210,0.047,1,37893,0.026,25,67475,0.371
2010,,Statewide Total,State,Medicaid,905,2027591,0.446,1362,358672,3.797,176,317215,0.555,1538,675887,2.276,2443,2703478,0.904,1,288050,0.003,0,12244,0,1,300294,0.003,2444,3003772,0.814
2012,58,Bronx,Urban,Medicare,20,67591,0.296,81,52150,1.553,5,13843,0.361,86,65993,1.303,106,133584,0.794,0,28660,0,0,324190,0,0,352850,0,106,486434,0.218
2012,88,Other than New York State,Urban,Medicaid,8,8909,0.898,14,1319,10.614,1,857,1.167,15,2176,6.893,23,11085,2.075,0,576,0,0,2847,0,0,3423,0,23,14508,1.585
2010,14,Erie,Urban,Commercial,92,113212,0.813,36,14154,2.543,2,23064,0.087,38,37218,1.021,130,150430,0.864,0,68863,0,0,74,0,0,68937,0,130,219367,0.593
2013,21,Herkimer,Urban,Commercial,2,7199,0.278,1,771,1.297,1,1205,0.83,2,1976,1.012,4,9175,0.436,0,4758,0,0,14414,0,0,19172,0,4,28347,0.141
2014,34,Orleans,Urban,Medicaid,4,3238,1.235,1,317,3.155,0,570,0,1,887,1.127,5,4125,1.212,0,669,0,1,1571,0.637,1,2240,0.446,6,6365,0.943
2011,17,Fulton,Rural,Medicare,1,1865,0.536,5,2358,2.12,0,1191,0,5,3549,1.409,6,5414,1.108,0,3262,0,0,6715,0,0,9977,0,6,15391,0.39
2015,5,Cayuga,Rural,Commercial,17,7839,2.169,4,833,4.802,2,1653,1.21,6,2486,2.414,23,10325,2.228,0,6081,0,3,9963,0.301,3,16044,0.187,26,26369,0.986
2015,46,Steuben,Rural,Other,1,2044,0.489,2,203,9.852,0,199,0,2,402,4.975,3,2446,1.226,0,948,0,0,1603,0,0,2551,0,3,4997,0.6
2015,58,Bronx,Urban,Commercial,64,243758,0.263,64,21853,2.929,13,16677,0.78,77,38530,1.998,141,282288,0.499,0,48960,0,4,300872,0.013,4,349832,0.011,145,632120,0.229
2012,3,Broome,Urban,Medicare,11,16328,0.674,21,8511,2.467,0,2574,0,21,11085,1.894,32,27413,1.167,0,7547,0,0,83314,0,0,90861,0,32,118274,0.271
2015,57,Yates,Urban,Commercial,5,3173,1.576,0,253,0,0,458,0,0,711,0,5,3884,1.287,0,1957,0,0,3495,0,0,5452,0,5,9336,0.536
2012,37,Putnam,Urban,Other,0,1070,0,0,110,0,0,64,0,0,174,0,0,1244,0,0,367,0,0,463,0,0,830,0,0,2074,0
2012,6,Chautauqua,Rural,Commercial,13,23534,0.552,6,1644,3.65,0,2283,0,6,3927,1.528,19,27461,0.692,0,8037,0,0,53025,0,0,61062,0,19,88523,0.215
2010,28,Nassau,Urban,Other,1,12466,0.08,3,1537,1.952,0,588,0,3,2125,1.412,4,14591,0.274,0,2196,0,0,191,0,0,2387,0,4,16978,0.236
2013,6,Chautauqua,Rural,Medicaid,30,21115,1.421,15,1752,8.562,0,2046,0,15,3798,3.949,45,24913,1.806,0,2429,0,0,13239,0,0,15668,0,45,40581,1.109
2011,19,Greene,Rural,Medicaid,2,3138,0.637,7,549,12.75,2,632,3.165,9,1181,7.621,11,4319,2.547,0,665,0,0,1867,0,0,2532,0,11,6851,1.606
2012,30,Oneida,Urban,Medicaid,22,38460,0.572,20,3929,5.09,4,4088,0.978,24,8017,2.994,46,46477,0.99,0,4917,0,1,13402,0.075,1,18319,0.055,47,64796,0.725
2014,39,Rockland,Urban,Commercial,14,34176,0.41,14,4085,3.427,3,5776,0.519,17,9861,1.724,31,44037,0.704,0,8088,0,0,25418,0,0,33506,0,31,77543,0.4
2015,24,Livingston,Urban,Commercial,9,5472,1.645,2,704,2.841,1,1130,0.885,3,1834,1.636,12,7306,1.642,1,4256,0.235,0,11049,0,1,15305,0.065,13,22611,0.575
2011,26,Monroe,Urban,Medicaid,54,75288,0.717,56,9028,6.203,1,9562,0.105,57,18590,3.066,111,93878,1.182,0,9284,0,0,81321,0,0,90605,0,111,184483,0.602
2014,26,Monroe,Urban,Other,4,6001,0.667,6,658,9.119,0,424,0,6,1082,5.545,10,7083,1.412,0,1948,0,0,4146,0,0,6094,0,10,13177,0.759
2015,7,Chemung,Urban,Commercial,15,14365,1.044,6,1025,5.854,0,1598,0,6,2623,2.287,21,16988,1.236,0,4349,0,0,61975,0,0,66324,0,21,83312,0.252
2012,23,Lewis,Rural,Commercial,0,4097,0,0,178,0,1,411,2.433,1,589,1.698,1,4686,0.213,0,1622,0,0,2889,0,0,4511,0,1,9197,0.109
2015,54,Wayne,Urban,Commercial,12,13380,0.897,7,1563,4.479,1,2054,0.487,8,3617,2.212,20,16997,1.177,0,8824,0,0,11998,0,0,20822,0,20,37819,0.529
2014,,Statewide Total,State,All Payers,4967,6823998,0.728,4036,1370833,2.944,503,996582,0.505,4539,2367415,1.917,9506,9191413,1.034,10,2253757,0.004,52,11030164,0.005,62,13283921,0.005,9568,22475334,0.426
2015,62,Richmond (Staten Island),Urban,Medicare,13,22372,0.581,52,18024,2.885,8,4978,1.607,60,23002,2.608,73,45374,1.609,1,12962,0.077,3,84505,0.036,4,97467,0.041,77,142841,0.539
2014,45,Seneca,Rural,Medicaid,5,3089,1.619,3,247,12.146,1,348,2.874,4,595,6.723,9,3684,2.443,0,480,0,0,1435,0,0,1915,0,9,5599,1.607
2015,5,Cayuga,Rural,Medicare,4,5160,0.775,12,2470,4.858,5,1656,3.019,17,4126,4.12,21,9286,2.261,0,3706,0,4,8418,0.475,4,12124,0.33,25,21410,1.168
2015,24,Livingston,Urban,Medicare,5,3604,1.387,7,1972,3.55,2,691,2.894,9,2663,3.38,14,6267,2.234,0,3248,0,0,8645,0,0,11893,0,14,18160,0.771
2012,8,Chenango,Rural,Commercial,10,10412,0.96,5,692,7.225,2,1278,1.565,7,1970,3.553,17,12382,1.373,0,2800,0,0,32514,0,0,35314,0,17,47696,0.356
2015,36,Otsego,Rural,Other,0,607,0,0,43,0,0,49,0,0,92,0,0,699,0,0,111,0,0,1181,0,0,1292,0,0,1991,0
2012,6,Chautauqua,Rural,Medicare,6,10946,0.548,7,3958,1.769,1,1427,0.701,8,5385,1.486,14,16331,0.857,0,4875,0,0,36658,0,0,41533,0,14,57864,0.242
2012,61,Queens,Urban,Other,4,18897,0.212,8,3352,2.387,1,1205,0.83,9,4557,1.975,13,23454,0.554,0,3743,0,0,52133,0,0,55876,0,13,79330,0.164
2013,51,Ulster,Urban,Medicare,7,12478,0.561,6,6976,0.86,0,3247,0,6,10223,0.587,13,22701,0.573,0,6470,0,0,12905,0,0,19375,0,13,42076,0.309
2012,43,Schoharie,Urban,Medicaid,1,3333,0.3,1,195,5.128,0,331,0,1,526,1.901,2,3859,0.518,0,452,0,0,4957,0,0,5409,0,2,9268,0.216
2012,50,Tompkins,Urban,Medicaid,9,6388,1.409,0,615,0,0,863,0,0,1478,0,9,7866,1.144,0,825,0,0,2455,0,0,3280,0,9,11146,0.807
2014,99,Unknown,Urban,Medicare,13,23418,0.555,22,10317,2.132,1,4027,0.248,23,14344,1.603,36,37762,0.953,0,23175,0,0,53640,0,0,76815,0,36,114577,0.314
2012,,Statewide Total,State,Other,83,240170,0.346,92,27663,3.326,7,17504,0.4,99,45167,2.192,182,285337,0.638,0,53755,0,0,245805,0,0,299560,0,182,584897,0.311
2014,60,New York (Manhattan),Urban,Commercial,79,216936,0.364,64,23669,2.704,9,34698,0.259,73,58367,1.251,152,275303,0.552,0,81421,0,1,265433,0.004,1,346854,0.003,153,622157,0.246
2014,32,Ontario,Urban,Medicare,3,6116,0.491,9,3220,2.795,0,1158,0,9,4378,2.056,12,10494,1.144,0,4789,0,0,10689,0,0,15478,0,12,25972,0.462
2011,9,Clinton,Rural,Medicare,2,5604,0.357,4,2679,1.493,0,789,0,4,3468,1.153,6,9072,0.661,0,5108,0,0,14195,0,0,19303,0,6,28375,0.211
2013,56,Wyoming,Rural,Other,0,805,0,0,134,0,0,91,0,0,225,0,0,1030,0,0,286,0,0,509,0,0,795,0,0,1825,0
2011,47,Suffolk,Urban,Medicare,35,58775,0.595,107,59220,1.807,3,16583,0.181,110,75803,1.451,145,134578,1.077,0,40484,0,3,70864,0.042,3,111348,0.027,148,245926,0.602
2014,49,Tioga,Urban,Medicare,3,1488,2.016,2,778,2.571,1,336,2.976,3,1114,2.693,6,2602,2.306,0,1226,0,0,9291,0,0,10517,0,6,13119,0.457
2013,99,Unknown,Urban,Medicare,15,33999,0.441,22,13418,1.64,5,6733,0.743,27,20151,1.34,42,54150,0.776,0,28166,0,0,69545,0,0,97711,0,42,151861,0.277
2014,3,Broome,Urban,Medicare,11,16369,0.672,7,7444,0.94,2,2436,0.821,9,9880,0.911,20,26249,0.762,0,8638,0,1,87708,0.011,1,96346,0.01,21,122595,0.171
2010,59,Kings (Brooklyn),Urban,Medicare,17,72680,0.234,67,64757,1.035,12,33358,0.36,79,98115,0.805,96,170795,0.562,1,46862,0.021,0,92,0,1,46954,0.021,97,217749,0.445
2015,22,Jefferson,Urban,Other,15,16928,0.886,2,865,2.312,0,2593,0,2,3458,0.578,17,20386,0.834,0,3206,0,0,5542,0,0,8748,0,17,29134,0.584
2013,99,Unknown,Urban,Medicaid,44,81344,0.541,49,9136,5.363,7,6782,1.032,56,15918,3.518,100,97262,1.028,0,11042,0,0,82271,0,0,93313,0,100,190575,0.525
2011,12,Delaware,Rural,Medicare,2,5425,0.369,2,1013,1.974,2,1849,1.082,4,2862,1.398,6,8287,0.724,0,3426,0,1,29367,0.034,1,32793,0.03,7,41080,0.17
2015,22,Jefferson,Urban,Medicaid,28,18761,1.492,8,979,8.172,1,1469,0.681,9,2448,3.676,37,21209,1.745,0,2149,0,0,6534,0,0,8683,0,37,29892,1.238
2015,24,Livingston,Urban,Other,1,814,1.229,0,95,0,0,48,0,0,143,0,1,957,1.045,0,309,0,0,800,0,0,1109,0,1,2066,0.484
2013,88,Other than New York State,Urban,Other,0,6367,0,5,579,8.636,0,619,0,5,1198,4.174,5,7565,0.661,0,1395,0,0,2107,0,0,3502,0,5,11067,0.452
2013,26,Monroe,Urban,Commercial,94,89893,1.046,58,11008,5.269,2,16846,0.119,60,27854,2.154,154,117747,1.308,0,45069,0,0,82288,0,0,127357,0,154,245104,0.628
2012,32,Ontario,Urban,Commercial,10,15893,0.629,12,1605,7.477,0,2554,0,12,4159,2.885,22,20052,1.097,0,9560,0,0,15267,0,0,24827,0,22,44879,0.49
2014,11,Cortland,Rural,Medicare,2,4057,0.493,4,1770,2.26,0,589,0,4,2359,1.696,6,6416,0.935,0,2373,0,0,4262,0,0,6635,0,6,13051,0.46
2015,3,Broome,Urban,Other,3,1211,2.477,0,125,0,0,96,0,0,221,0,3,1432,2.095,0,256,0,0,1084,0,0,1340,0,3,2772,1.082
2013,29,Niagara,Urban,Commercial,32,34641,0.924,22,5348,4.114,3,5892,0.509,25,11240,2.224,57,45881,1.242,1,20353,0.049,0,63629,0,1,83982,0.012,58,129863,0.447
2013,12,Delaware,Rural,Medicare,2,5587,0.358,0,1054,0,1,1549,0.646,1,2603,0.384,3,8190,0.366,0,2040,0,0,41920,0,0,43960,0,3,52150,0.058
2014,13,Dutchess,Urban,Commercial,67,44521,1.505,13,4774,2.723,0,7250,0,13,12024,1.081,80,56545,1.415,0,17044,0,0,24263,0,0,41307,0,80,97852,0.818
2015,18,Genesee,Rural,Commercial,9,6823,1.319,3,826,3.632,1,1397,0.716,4,2223,1.799,13,9046,1.437,0,4568,0,0,15627,0,0,20195,0,13,29241,0.445
2012,27,Montgomery,Rural,Commercial,2,12123,0.165,5,681,7.342,1,1140,0.877,6,1821,3.295,8,13944,0.574,0,4741,0,0,13700,0,0,18441,0,8,32385,0.247
2014,45,Seneca,Rural,Medicare,1,2240,0.446,5,1263,3.959,0,466,0,5,1729,2.892,6,3969,1.512,0,1615,0,0,4227,0,0,5842,0,6,9811,0.612
2015,33,Orange,Urban,Other,3,4811,0.624,0,576,0,0,319,0,0,895,0,3,5706,0.526,0,931,0,0,1670,0,0,2601,0,3,8307,0.361
2011,39,Rockland,Urban,Commercial,7,36238,0.193,12,5456,2.199,2,6709,0.298,14,12165,1.151,21,48403,0.434,0,9680,0,1,21018,0.048,1,30698,0.033,22,79101,0.278
2015,7,Chemung,Urban,Other,0,973,0,0,110,0,0,121,0,0,231,0,0,1204,0,0,473,0,0,3081,0,0,3554,0,0,4758,0
2013,30,Oneida,Urban,Other,4,4461,0.897,2,491,4.073,0,408,0,2,899,2.225,6,5360,1.119,0,846,0,0,3963,0,0,4809,0,6,10169,0.59
2014,38,Rensselaer,Urban,Medicare,3,8822,0.34,11,4155,2.647,0,1712,0,11,5867,1.875,14,14689,0.953,0,6744,0,0,11723,0,0,18467,0,14,33156,0.422
2014,13,Dutchess,Urban,Medicare,14,17272,0.811,24,9632,2.492,0,3150,0,24,12782,1.878,38,30054,1.264,0,10380,0,0,23270,0,0,33650,0,38,63704,0.597
2012,40,St. Lawrence,Rural,Medicare,3,10303,0.291,7,3753,1.865,2,1654,1.209,9,5407,1.665,12,15710,0.764,0,4947,0,0,13643,0,0,18590,0,12,34300,0.35
2013,16,Franklin,Rural,Commercial,4,3518,1.137,4,342,11.696,0,555,0,4,897,4.459,8,4415,1.812,0,1632,0,0,4011,0,0,5643,0,8,10058,0.795
2012,88,Other than New York State,Urban,Commercial,42,69423,0.605,15,9546,1.571,8,20807,0.384,23,30353,0.758,65,99776,0.651,0,35794,0,0,50344,0,0,86138,0,65,185914,0.35
2013,29,Niagara,Urban,Other,1,2499,0.4,0,221,0,0,303,0,0,524,0,1,3023,0.331,0,627,0,0,1549,0,0,2176,0,1,5199,0.192
2011,40,St. Lawrence,Rural,Medicaid,3,20899,0.144,8,1499,5.337,0,1981,0,8,3480,2.299,11,24379,0.451,0,1692,0,0,7793,0,0,9485,0,11,33864,0.325
2015,6,Chautauqua,Rural,Other,2,1364,1.466,1,122,8.197,0,132,0,1,254,3.937,3,1618,1.854,0,255,0,0,938,0,0,1193,0,3,2811,1.067
2011,14,Erie,Urban,Medicaid,124,108978,1.138,115,12028,9.561,6,12894,0.465,121,24922,4.855,245,133900,1.83,0,12815,0,0,104991,0,0,117806,0,245,251706,0.973
2014,47,Suffolk,Urban,Other,5,14111,0.354,0,1288,0,0,501,0,0,1789,0,5,15900,0.314,0,6553,0,0,3444,0,0,9997,0,5,25897,0.193
2013,32,Ontario,Urban,Medicare,2,6174,0.324,10,3454,2.895,0,1309,0,10,4763,2.1,12,10937,1.097,0,4878,0,1,10763,0.093,1,15641,0.064,13,26578,0.489
2011,,Statewide Total,State,Medicaid,1067,2393369,0.446,1588,389460,4.077,194,331141,0.586,1782,720601,2.473,2849,3113970,0.915,3,307600,0.01,22,4622263,0.005,25,4929863,0.005,2874,8043833,0.357
2011,55,Westchester,Urban,Medicaid,30,75026,0.4,36,11260,3.197,4,13013,0.307,40,24273,1.648,70,99299,0.705,0,6982,0,0,149228,0,0,156210,0,70,255509,0.274
2013,9,Clinton,Rural,Medicaid,2,9518,0.21,5,531,9.416,0,619,0,5,1150,4.348,7,10668,0.656,0,979,0,0,8203,0,0,9182,0,7,19850,0.353
2013,59,Kings (Brooklyn),Urban,Other,3,20033,0.15,2,2664,0.751,0,1163,0,2,3827,0.523,5,23860,0.21,0,4489,0,0,25479,0,0,29968,0,5,53828,0.093
2010,30,Oneida,Urban,Medicaid,20,25413,0.787,22,3146,6.993,6,4428,1.355,28,7574,3.697,48,32987,1.455,0,4781,0,0,18,0,0,4799,0,48,37786,1.27
2013,33,Orange,Urban,Medicaid,23,32403,0.71,32,3697,8.656,2,5787,0.346,34,9484,3.585,57,41887,1.361,0,4335,0,0,8218,0,0,12553,0,57,54440,1.047
2012,46,Steuben,Rural,Medicare,4,8262,0.484,9,3692,2.438,2,1590,1.258,11,5282,2.083,15,13544,1.108,0,4595,0,0,10477,0,0,15072,0,15,28616,0.524
2015,51,Ulster,Urban,Medicare,17,13834,1.229,19,7220,2.632,2,2698,0.741,21,9918,2.117,38,23752,1.6,0,6794,0,0,16667,0,0,23461,0,38,47213,0.805
2010,,Statewide Total,State,Commercial,1086,2745644,0.396,999,392588,2.545,103,469255,0.219,1102,861843,1.279,2188,3607487,0.607,5,1075978,0.005,1,15113,0.066,6,1091091,0.005,2194,4698578,0.467
2013,6,Chautauqua,Rural,Other,1,1548,0.646,1,140,7.143,0,134,0,1,274,3.65,2,1822,1.098,0,251,0,0,1201,0,0,1452,0,2,3274,0.611
2013,48,Sullivan,Rural,Medicaid,2,4561,0.439,5,771,6.485,0,886,0,5,1657,3.018,7,6218,1.126,0,980,0,0,2818,0,0,3798,0,7,10016,0.699
2015,10,Columbia,Rural,Other,0,606,0,0,59,0,0,25,0,0,84,0,0,690,0,0,107,0,0,367,0,0,474,0,0,1164,0
2014,19,Greene,Rural,Medicaid,6,4119,1.457,8,568,14.085,0,667,0,8,1235,6.478,14,5354,2.615,0,901,0,0,1979,0,0,2880,0,14,8234,1.7
2011,2,Allegany,Rural,Other,0,741,0,1,71,14.085,0,46,0,1,117,8.547,1,858,1.166,0,130,0,0,1184,0,0,1314,0,1,2172,0.46
2015,50,Tompkins,Urban,Medicare,4,4559,0.877,8,1928,4.149,0,693,0,8,2621,3.052,12,7180,1.671,0,2674,0,1,9986,0.1,1,12660,0.079,13,19840,0.655
2015,59,Kings (Brooklyn),Urban,Other,5,17143,0.292,6,1478,4.06,0,940,0,6,2418,2.481,11,19561,0.562,0,5714,0,0,22393,0,0,28107,0,11,47668,0.231
2011,43,Schoharie,Urban,Commercial,2,5574,0.359,0,312,0,1,695,1.439,1,1007,0.993,3,6581,0.456,0,3052,0,0,18690,0,0,21742,0,3,28323,0.106
2015,13,Dutchess,Urban,Other,8,3779,2.117,5,524,9.542,0,242,0,5,766,6.527,13,4545,2.86,0,1793,0,0,1474,0,0,3267,0,13,7812,1.664
2012,51,Ulster,Urban,Medicare,11,10677,1.03,13,7240,1.796,1,3261,0.307,14,10501,1.333,25,21178,1.18,0,6791,0,0,13495,0,0,20286,0,25,41464,0.603
2011,42,Schenectady,Urban,Commercial,19,29691,0.64,1,995,1.005,6,5326,1.127,7,6321,1.107,26,36012,0.722,0,13278,0,1,23593,0.042,1,36871,0.027,27,72883,0.37
2013,22,Jefferson,Urban,Medicare,1,7386,0.135,8,2947,2.715,0,1653,0,8,4600,1.739,9,11986,0.751,0,3726,0,0,10185,0,0,13911,0,9,25897,0.348
2011,43,Schoharie,Urban,Medicaid,2,3218,0.622,2,177,11.299,2,345,5.797,4,522,7.663,6,3740,1.604,0,690,0,0,16874,0,0,17564,0,6,21304,0.282
2014,,Statewide Total,State,Commercial,2209,2796874,0.79,977,313588,3.116,123,413900,0.297,1100,727488,1.512,3309,3524362,0.939,4,1120655,0.004,13,3262734,0.004,17,4383389,0.004,3326,7907751,0.421
2012,11,Cortland,Rural,Medicaid,4,9497,0.421,6,577,10.399,0,765,0,6,1342,4.471,10,10839,0.923,0,640,0,0,2249,0,0,2889,0,10,13728,0.728
2010,2,Allegany,Rural,Commercial,1,5833,0.171,3,665,4.511,2,1279,1.564,5,1944,2.572,6,7777,0.772,0,3032,0,0,98,0,0,3130,0,6,10907,0.55
2011,59,Kings (Brooklyn),Urban,Medicare,19,83473,0.228,73,79845,0.914,5,31067,0.161,78,110912,0.703,97,194385,0.499,0,51444,0,0,362360,0,0,413804,0,97,608189,0.159
2014,15,Essex,Rural,Commercial,0,6751,0,1,334,2.994,0,511,0,1,845,1.183,1,7596,0.132,0,1961,0,0,7945,0,0,9906,0,1,17502,0.057
2013,54,Wayne,Urban,Medicaid,6,7625,0.787,4,724,5.525,0,967,0,4,1691,2.365,10,9316,1.073,0,1442,0,0,3483,0,0,4925,0,10,14241,0.702
2015,23,Lewis,Rural,Medicaid,2,3075,0.65,1,196,5.102,1,360,2.778,2,556,3.597,4,3631,1.102,0,483,0,0,1245,0,0,1728,0,4,5359,0.746
2014,36,Otsego,Rural,Commercial,14,9213,1.52,5,749,6.676,0,1272,0,5,2021,2.474,19,11234,1.691,0,4226,0,1,29659,0.034,1,33885,0.03,20,45119,0.443
2011,28,Nassau,Urban,Medicare,16,46768,0.342,59,56126,1.051,7,18368,0.381,66,74494,0.886,82,121262,0.676,0,33826,0,0,87615,0,0,121441,0,82,242703,0.338
2014,19,Greene,Rural,Commercial,9,4793,1.878,1,717,1.395,1,931,1.074,2,1648,1.214,11,6441,1.708,0,3177,0,0,4954,0,0,8131,0,11,14572,0.755
2014,6,Chautauqua,Rural,Commercial,24,20475,1.172,8,1401,5.71,0,2121,0,8,3522,2.271,32,23997,1.334,0,7719,0,0,23993,0,0,31712,0,32,55709,0.574
2011,58,Bronx,Urban,Other,4,12182,0.328,2,1548,1.292,0,650,0,2,2198,0.91,6,14380,0.417,0,2974,0,0,40252,0,0,43226,0,6,57606,0.104
2012,10,Columbia,Rural,Medicaid,3,6404,0.468,4,627,6.38,0,699,0,4,1326,3.017,7,7730,0.906,0,785,0,0,2295,0,0,3080,0,7,10810,0.648
2013,57,Yates,Urban,Commercial,2,3183,0.628,1,239,4.184,0,494,0,1,733,1.364,3,3916,0.766,0,1896,0,0,3537,0,0,5433,0,3,9349,0.321
2011,31,Onondaga,Urban,Medicaid,34,42702,0.796,29,5550,5.225,0,6959,0,29,12509,2.318,63,55211,1.141,0,4525,0,1,35679,0.028,1,40204,0.025,64,95415,0.671
2010,10,Columbia,Rural,Commercial,3,11432,0.262,2,1192,1.678,1,1384,0.723,3,2576,1.165,6,14008,0.428,0,4244,0,0,7,0,0,4251,0,6,18259,0.329
2014,47,Suffolk,Urban,Medicare,49,73476,0.667,123,57511,2.139,8,15459,0.517,131,72970,1.795,180,146446,1.229,0,59277,0,2,77840,0.026,2,137117,0.015,182,283563,0.642
2010,61,Queens,Urban,Medicare,9,43874,0.205,49,57840,0.847,4,19485,0.205,53,77325,0.685,62,121199,0.512,0,29859,0,0,742,0,0,30601,0,62,151800,0.408
2015,39,Rockland,Urban,Medicare,5,14550,0.344,10,9343,1.07,5,3391,1.474,15,12734,1.178,20,27284,0.733,0,4743,0,1,28592,0.035,1,33335,0.03,21,60619,0.346
2014,,Statewide Total,State,Medicare,554,1048043,0.529,1241,642835,1.931,141,236453,0.596,1382,879288,1.572,1936,1927331,1.004,1,692108,0.001,16,2937262,0.005,17,3629370,0.005,1953,5556701,0.351
2013,47,Suffolk,Urban,Other,5,13283,0.376,2,1231,1.625,0,446,0,2,1677,1.193,7,14960,0.468,0,5231,0,0,2515,0,0,7746,0,7,22706,0.308
2015,6,Chautauqua,Rural,Commercial,26,19210,1.353,4,1103,3.626,2,1933,1.035,6,3036,1.976,32,22246,1.438,0,7396,0,0,23279,0,0,30675,0,32,52921,0.605
2011,14,Erie,Urban,Medicare,34,50345,0.675,74,35246,2.1,2,10799,0.185,76,46045,1.651,110,96390,1.141,0,33736,0,0,78246,0,0,111982,0,110,208372,0.528
2014,58,Bronx,Urban,Commercial,79,265655,0.297,46,23329,1.972,5,17472,0.286,51,40801,1.25,130,306456,0.424,0,49054,0,0,295882,0,0,344936,0,130,651392,0.2
2012,21,Herkimer,Urban,Medicare,1,4755,0.21,5,2682,1.864,2,1178,1.698,7,3860,1.813,8,8615,0.929,0,2944,0,1,10121,0.099,1,13065,0.077,9,21680,0.415
2011,50,Tompkins,Urban,Medicare,4,4846,0.825,6,1900,3.158,0,768,0,6,2668,2.249,10,7514,1.331,0,2464,0,0,6279,0,0,8743,0,10,16257,0.615
2012,48,Sullivan,Rural,Commercial,14,12586,1.112,7,1183,5.917,2,1761,1.136,9,2944,3.057,23,15530,1.481,0,4486,0,0,6197,0,0,10683,0,23,26213,0.877
2013,8,Chenango,Rural,Commercial,2,9455,0.212,1,623,1.605,0,1211,0,1,1834,0.545,3,11289,0.266,0,2996,0,0,36214,0,0,39210,0,3,50499,0.059
2013,3,Broome,Urban,Other,0,1842,0,0,187,0,1,115,8.696,1,302,3.311,1,2144,0.466,0,285,0,0,1894,0,0,2179,0,1,4323,0.231
2015,17,Fulton,Rural,Other,0,804,0,0,58,0,0,43,0,0,101,0,0,905,0,0,167,0,0,529,0,0,696,0,0,1601,0
2012,43,Schoharie,Urban,Medicare,0,2715,0,2,798,2.506,0,653,0,2,1451,1.378,2,4166,0.48,0,1302,0,0,11819,0,0,13121,0,2,17287,0.116
2011,53,Washington,Urban,Medicare,1,3146,0.318,3,2673,1.122,0,806,0,3,3479,0.862,4,6625,0.604,0,2931,0,0,6795,0,0,9726,0,4,16351,0.245
2012,3,Broome,Urban,Commercial,38,24338,1.561,17,2603,6.531,3,3891,0.771,20,6494,3.08,58,30832,1.881,0,10595,0,0,34417,0,0,45012,0,58,75844,0.765
2015,39,Rockland,Urban,Medicaid,14,27009,0.518,11,3943,2.79,2,7844,0.255,13,11787,1.103,27,38796,0.696,0,3864,0,0,21301,0,0,25165,0,27,63961,0.422
2014,42,Schenectady,Urban,Other,0,1088,0,0,63,0,0,333,0,0,396,0,0,1484,0,0,271,0,0,2147,0,0,2418,0,0,3902,0
2014,48,Sullivan,Rural,Other,1,1104,0.906,0,161,0,0,71,0,0,232,0,1,1336,0.749,0,253,0,0,427,0,0,680,0,1,2016,0.496
2011,4,Cattaraugus,Rural,Other,1,1257,0.796,0,152,0,1,132,7.576,1,284,3.521,2,1541,1.298,0,272,0,0,796,0,0,1068,0,2,2609,0.767
2014,28,Nassau,Urban,Medicare,20,56212,0.356,77,47247,1.63,12,18060,0.664,89,65307,1.363,109,121519,0.897,0,43864,0,3,121052,0.025,3,164916,0.018,112,286435,0.391
2013,22,Jefferson,Urban,Other,6,17663,0.34,5,1001,4.995,0,2791,0,5,3792,1.319,11,21455,0.513,0,3286,0,0,4949,0,0,8235,0,11,29690,0.37
2013,10,Columbia,Rural,Medicare,4,4544,0.88,9,2653,3.392,1,773,1.294,10,3426,2.919,14,7970,1.757,0,2807,0,0,6466,0,0,9273,0,14,17243,0.812
2014,54,Wayne,Urban,Medicare,3,6222,0.482,5,3467,1.442,1,1194,0.838,6,4661,1.287,9,10883,0.827,0,4963,0,0,12723,0,0,17686,0,9,28569,0.315
2015,39,Rockland,Urban,Other,1,2760,0.362,0,146,0,0,73,0,0,219,0,1,2979,0.336,0,141,0,0,1246,0,0,1387,0,1,4366,0.229
2013,3,Broome,Urban,Commercial,50,25166,1.987,11,3286,3.348,2,3968,0.504,13,7254,1.792,63,32420,1.943,0,11728,0,1,66439,0.015,1,78167,0.013,64,110587,0.579
2013,29,Niagara,Urban,Medicaid,30,22174,1.353,15,2819,5.321,1,2746,0.364,16,5565,2.875,46,27739,1.658,0,3145,0,0,15053,0,0,18198,0,46,45937,1.001
2014,12,Delaware,Rural,Medicaid,6,5921,1.013,0,306,0,2,593,3.373,2,899,2.225,8,6820,1.173,0,722,0,0,13305,0,0,14027,0,8,20847,0.384
2013,14,Erie,Urban,Other,4,12540,0.319,3,1183,2.536,0,1418,0,3,2601,1.153,7,15141,0.462,0,3072,0,0,6633,0,0,9705,0,7,24846,0.282
2011,4,Cattaraugus,Rural,Medicare,1,5747,0.174,6,2833,2.118,0,1396,0,6,4229,1.419,7,9976,0.702,0,3684,0,0,7045,0,0,10729,0,7,20705,0.338
2014,24,Livingston,Urban,Other,0,835,0,0,126,0,0,54,0,0,180,0,0,1015,0,0,355,0,0,727,0,0,1082,0,0,2097,0
2014,39,Rockland,Urban,Medicaid,13,24487,0.531,10,3562,2.807,2,7733,0.259,12,11295,1.062,25,35782,0.699,0,3536,0,0,19699,0,0,23235,0,25,59017,0.424
2014,25,Madison,Urban,Medicare,2,4344,0.46,6,1829,3.28,0,920,0,6,2749,2.183,8,7093,1.128,0,3780,0,0,6515,0,0,10295,0,8,17388,0.46
2012,11,Cortland,Rural,Commercial,5,10220,0.489,3,690,4.348,0,933,0,3,1623,1.848,8,11843,0.676,0,2454,0,0,4656,0,0,7110,0,8,18953,0.422
2013,22,Jefferson,Urban,Commercial,15,21552,0.696,3,1549,1.937,1,2510,0.398,4,4059,0.985,19,25611,0.742,0,5702,0,0,10145,0,0,15847,0,19,41458,0.458
2013,44,Schuyler,Rural,Medicare,2,2081,0.961,0,362,0,0,626,0,0,988,0,2,3069,0.652,0,780,0,0,7512,0,0,8292,0,2,11361,0.176
2014,51,Ulster,Urban,Commercial,32,26131,1.225,7,2583,2.71,2,4114,0.486,9,6697,1.344,41,32828,1.249,0,9767,0,0,13292,0,0,23059,0,41,55887,0.734
2015,52,Warren,Urban,Medicare,4,5655,0.707,9,2955,3.046,2,952,2.101,11,3907,2.815,15,9562,1.569,1,4070,0.246,0,11068,0,1,15138,0.066,16,24700,0.648
2011,58,Bronx,Urban,Commercial,60,286913,0.209,32,27266,1.174,13,20568,0.632,45,47834,0.941,105,334747,0.314,0,48783,0,0,302654,0,0,351437,0,105,686184,0.153
2010,26,Monroe,Urban,Medicaid,28,61584,0.455,40,7896,5.066,3,9223,0.325,43,17119,2.512,71,78703,0.902,0,8141,0,0,2318,0,0,10459,0,71,89162,0.796
2010,1,Albany,Urban,Medicaid,20,25246,0.792,9,3312,2.717,2,3820,0.524,11,7132,1.542,31,32378,0.957,1,5268,0.19,0,19,0,1,5287,0.189,32,37665,0.85
2014,26,Monroe,Urban,Commercial,127,86989,1.46,70,10271,6.815,5,16000,0.313,75,26271,2.855,202,113260,1.784,0,47241,0,0,79247,0,0,126488,0,202,239748,0.843
2015,3,Broome,Urban,Commercial,68,19190,3.544,14,2431,5.759,1,3116,0.321,15,5547,2.704,83,24737,3.355,0,12781,0,2,35550,0.056,2,48331,0.041,85,73068,1.163
2015,2,Allegany,Rural,Other,0,500,0,0,47,0,0,42,0,0,89,0,0,589,0,0,148,0,0,868,0,0,1016,0,0,1605,0
2014,8,Chenango,Rural,Medicaid,6,9115,0.658,1,355,2.817,6,781,7.682,7,1136,6.162,13,10251,1.268,3,1032,2.907,1,10910,0.092,4,11942,0.335,17,22193,0.766
2010,2,Allegany,Rural,Medicare,0,2852,0,4,1573,2.543,0,879,0,4,2452,1.631,4,5304,0.754,0,2052,0,0,36,0,0,2088,0,4,7392,0.541
2011,2,Allegany,Rural,Commercial,2,11269,0.177,4,718,5.571,0,1197,0,4,1915,2.089,6,13184,0.455,0,3403,0,0,11452,0,0,14855,0,6,28039,0.214
2013,43,Schoharie,Urban,Medicaid,1,2904,0.344,0,170,0,1,376,2.66,1,546,1.832,2,3450,0.58,0,456,0,0,14463,0,0,14919,0,2,18369,0.109
2011,13,Dutchess,Urban,Commercial,47,46127,1.019,23,5473,4.202,0,7924,0,23,13397,1.717,70,59524,1.176,0,16064,0,0,25815,0,0,41879,0,70,101403,0.69
2014,47,Suffolk,Urban,Medicaid,211,115507,1.827,136,20725,6.562,8,16681,0.48,144,37406,3.85,355,152913,2.322,0,17762,0,1,61708,0.016,1,79470,0.013,356,232383,1.532
2015,,Statewide Total,State,Commercial,2589,2686970,0.964,1231,302132,4.074,316,398216,0.794,1547,700348,2.209,4136,3387318,1.221,7,1105296,0.006,42,3551900,0.012,49,4657196,0.011,4185,8044514,0.52
2012,10,Columbia,Rural,Commercial,7,9133,0.766,4,1026,3.899,0,1066,0,4,2092,1.912,11,11225,0.98,0,3837,0,0,5865,0,0,9702,0,11,20927,0.526
2012,36,Otsego,Rural,Medicaid,0,6203,0,3,439,6.834,0,702,0,3,1141,2.629,3,7344,0.408,0,832,0,0,13950,0,0,14782,0,3,22126,0.136
2010,58,Bronx,Urban,Medicaid,90,381381,0.236,201,66188,3.037,43,48114,0.894,244,114302,2.135,334,495683,0.674,0,42727,0,0,1089,0,0,43816,0,334,539499,0.619
2013,35,Oswego,Urban,Medicaid,19,10523,1.806,6,1432,4.19,3,1687,1.778,9,3119,2.886,28,13642,2.052,0,2378,0,0,12920,0,0,15298,0,28,28940,0.968
2014,33,Orange,Urban,Commercial,64,58585,1.092,43,6861,6.267,1,8824,0.113,44,15685,2.805,108,74270,1.454,0,21372,0,0,25945,0,0,47317,0,108,121587,0.888
2013,26,Monroe,Urban,Medicaid,76,83372,0.912,70,9308,7.52,1,9622,0.104,71,18930,3.751,147,102302,1.437,0,10952,0,2,64769,0.031,2,75721,0.026,149,178023,0.837
2015,49,Tioga,Urban,Medicaid,6,1646,3.645,3,229,13.1,0,371,0,3,600,5,9,2246,4.007,0,502,0,0,2708,0,0,3210,0,9,5456,1.65
2014,53,Washington,Urban,Commercial,10,6659,1.502,5,863,5.794,1,1001,0.999,6,1864,3.219,16,8523,1.877,0,3961,0,0,5607,0,0,9568,0,16,18091,0.884
2013,47,Suffolk,Urban,Medicare,40,67456,0.593,112,58620,1.911,3,15391,0.195,115,74011,1.554,155,141467,1.096,0,55425,0,0,64214,0,0,119639,0,155,261106,0.594
2014,42,Schenectady,Urban,Medicaid,23,28368,0.811,2,643,3.11,12,3965,3.026,14,4608,3.038,37,32976,1.122,0,3020,0,1,16197,0.062,1,19217,0.052,38,52193,0.728
2011,47,Suffolk,Urban,Other,2,12850,0.156,2,1324,1.511,0,474,0,2,1798,1.112,4,14648,0.273,0,4902,0,0,1984,0,0,6886,0,4,21534,0.186
2015,18,Genesee,Rural,Other,1,704,1.42,0,76,0,1,48,20.833,1,124,8.065,2,828,2.415,0,176,0,0,870,0,0,1046,0,2,1874,1.067
2013,14,Erie,Urban,Commercial,191,110532,1.728,61,12180,5.008,5,20907,0.239,66,33087,1.995,257,143619,1.789,0,76937,0,0,133059,0,0,209996,0,257,353615,0.727
2014,19,Greene,Rural,Other,0,538,0,2,174,11.494,0,80,0,2,254,7.874,2,792,2.525,0,288,0,0,481,0,0,769,0,2,1561,1.281
2015,48,Sullivan,Rural,Medicare,5,6543,0.764,11,2924,3.762,0,917,0,11,3841,2.864,16,10384,1.541,0,3228,0,0,10932,0,0,14160,0,16,24544,0.652
2014,62,Richmond (Staten Island),Urban,Medicare,26,21820,1.192,68,19751,3.443,3,4737,0.633,71,24488,2.899,97,46308,2.095,1,13676,0.073,0,93550,0,1,107226,0.009,98,153534,0.638
2010,61,Queens,Urban,Commercial,50,269872,0.185,68,46695,1.456,1,43143,0.023,69,89838,0.768,119,359710,0.331,0,66577,0,0,1011,0,0,67588,0,119,427298,0.278
2012,4,Cattaraugus,Rural,Other,0,508,0,1,108,9.259,0,77,0,1,185,5.405,1,693,1.443,0,181,0,0,566,0,0,747,0,1,1440,0.694
2015,20,Hamilton,Rural,Other,0,32,0,0,2,0,0,9,0,0,11,0,0,43,0,0,18,0,0,56,0,0,74,0,0,117,0
2014,18,Genesee,Rural,Medicaid,5,5684,0.88,6,550,10.909,0,779,0,6,1329,4.515,11,7013,1.569,0,1062,0,0,7695,0,0,8757,0,11,15770,0.698
2012,28,Nassau,Urban,Commercial,76,180106,0.422,93,32572,2.855,5,37635,0.133,98,70207,1.396,174,250313,0.695,0,73771,0,0,164212,0,0,237983,0,174,488296,0.356
2011,4,Cattaraugus,Rural,Medicaid,7,9720,0.72,5,752,6.649,2,1145,1.747,7,1897,3.69,14,11617,1.205,0,1524,0,0,5408,0,0,6932,0,14,18549,0.755
2014,42,Schenectady,Urban,Medicare,9,12422,0.725,1,1097,0.912,7,6331,1.106,8,7428,1.077,17,19850,0.856,0,7860,0,0,20201,0,0,28061,0,17,47911,0.355
2014,57,Yates,Urban,Medicaid,3,3088,0.972,1,150,6.667,0,247,0,1,397,2.519,4,3485,1.148,0,405,0,0,1313,0,0,1718,0,4,5203,0.769
2011,48,Sullivan,Rural,Medicare,3,4346,0.69,12,2603,4.61,0,1292,0,12,3895,3.081,15,8241,1.82,0,2262,0,0,8088,0,0,10350,0,15,18591,0.807
2015,57,Yates,Urban,Medicare,3,2195,1.367,5,636,7.862,2,414,4.831,7,1050,6.667,10,3245,3.082,0,1388,0,0,4508,0,0,5896,0,10,9141,1.094
2015,17,Fulton,Rural,Commercial,3,12985,0.231,5,698,7.163,1,899,1.112,6,1597,3.757,9,14582,0.617,0,4105,0,0,10102,0,0,14207,0,9,28789,0.313
2011,9,Clinton,Rural,Medicaid,1,7149,0.14,8,621,12.882,0,917,0,8,1538,5.202,9,8687,1.036,0,1323,0,0,6759,0,0,8082,0,9,16769,0.537
2012,18,Genesee,Rural,Medicare,1,3569,0.28,6,2516,2.385,0,978,0,6,3494,1.717,7,7063,0.991,0,3020,0,0,13207,0,0,16227,0,7,23290,0.301
2012,51,Ulster,Urban,Medicaid,15,17439,0.86,9,1501,5.996,0,2453,0,9,3954,2.276,24,21393,1.122,0,1853,0,0,4815,0,0,6668,0,24,28061,0.855
2014,62,Richmond (Staten Island),Urban,Commercial,43,55360,0.777,42,10445,4.021,1,8506,0.118,43,18951,2.269,86,74311,1.157,3,19873,0.151,1,73591,0.014,4,93464,0.043,90,167775,0.536
2015,88,Other than New York State,Urban,Medicaid,11,13540,0.812,14,2073,6.753,1,1182,0.846,15,3255,4.608,26,16795,1.548,0,849,0,0,5489,0,0,6338,0,26,23133,1.124
2011,48,Sullivan,Rural,Medicaid,5,9757,0.512,5,1463,3.418,2,1338,1.495,7,2801,2.499,12,12558,0.956,0,1267,0,0,4681,0,0,5948,0,12,18506,0.648
2015,12,Delaware,Rural,Medicaid,7,6641,1.054,2,284,7.042,4,559,7.156,6,843,7.117,13,7484,1.737,0,770,0,1,13984,0.072,1,14754,0.068,14,22238,0.63
2015,1,Albany,Urban,Medicaid,39,41399,0.942,25,3966,6.304,3,3734,0.803,28,7700,3.636,67,49099,1.365,0,5050,0,0,39440,0,0,44490,0,67,93589,0.716
2013,43,Schoharie,Urban,Medicare,1,2659,0.376,1,777,1.287,0,708,0,1,1485,0.673,2,4144,0.483,0,1508,0,0,22918,0,0,24426,0,2,28570,0.07
2011,10,Columbia,Rural,Commercial,11,10922,1.007,5,1191,4.198,0,1178,0,5,2369,2.111,16,13291,1.204,0,3863,0,0,6594,0,0,10457,0,16,23748,0.674
2013,19,Greene,Rural,Commercial,5,5095,0.981,3,806,3.722,0,886,0,3,1692,1.773,8,6787,1.179,0,3164,0,0,4731,0,0,7895,0,8,14682,0.545
2011,61,Queens,Urban,Other,3,17445,0.172,8,4176,1.916,0,1280,0,8,5456,1.466,11,22901,0.48,0,3401,0,0,58943,0,0,62344,0,11,85245,0.129
2014,9,Clinton,Rural,Medicaid,6,10460,0.574,5,775,6.452,0,732,0,5,1507,3.318,11,11967,0.919,0,1351,0,0,3448,0,0,4799,0,11,16766,0.656
2011,1,Albany,Urban,Medicare,8,17160,0.466,20,11386,1.757,1,3747,0.267,21,15133,1.388,29,32293,0.898,0,10312,0,0,27153,0,0,37465,0,29,69758,0.416
2015,5,Cayuga,Rural,Other,3,1065,2.817,0,145,0,1,127,7.874,1,272,3.676,4,1337,2.992,0,475,0,0,1208,0,0,1683,0,4,3020,1.325
2012,1,Albany,Urban,Commercial,30,40673,0.738,23,4652,4.944,0,5590,0,23,10242,2.246,53,50915,1.041,0,21073,0,0,27391,0,0,48464,0,53,99379,0.533
2014,5,Cayuga,Rural,Medicare,4,5069,0.789,4,2721,1.47,5,1204,4.153,9,3925,2.293,13,8994,1.445,0,4062,0,1,8507,0.118,1,12569,0.08,14,21563,0.649
2015,99,Unknown,Urban,Other,4,4942,0.809,2,346,5.78,0,163,0,2,509,3.929,6,5451,1.101,0,3669,0,0,1541,0,0,5210,0,6,10661,0.563
2012,50,Tompkins,Urban,Other,0,636,0,0,54,0,0,43,0,0,97,0,0,733,0,0,59,0,0,232,0,0,291,0,0,1024,0
2011,2,Allegany,Rural,Medicare,2,3791,0.528,2,1610,1.242,0,711,0,2,2321,0.862,4,6112,0.654,0,2271,0,0,6450,0,0,8721,0,4,14833,0.27
2015,13,Dutchess,Urban,Commercial,66,37945,1.739,25,4760,5.252,3,7002,0.428,28,11762,2.381,94,49707,1.891,0,16373,0,1,23730,0.042,1,40103,0.025,95,89810,1.058
2011,61,Queens,Urban,Medicare,11,61746,0.178,72,66066,1.09,14,24849,0.563,86,90915,0.946,97,152661,0.635,0,35476,0,0,254200,0,0,289676,0,97,442337,0.219
2013,38,Rensselaer,Urban,Medicaid,4,9965,0.401,12,1725,6.957,1,1904,0.525,13,3629,3.582,17,13594,1.251,0,2292,0,0,7586,0,0,9878,0,17,23472,0.724
2015,35,Oswego,Urban,Medicare,10,6839,1.462,15,4271,3.512,3,1556,1.928,18,5827,3.089,28,12666,2.211,1,6840,0.146,0,13378,0,1,20218,0.049,29,32884,0.882
2014,40,St. Lawrence,Rural,Medicaid,4,14789,0.27,3,1098,2.732,0,1415,0,3,2513,1.194,7,17302,0.405,0,2079,0,0,6367,0,0,8446,0,7,25748,0.272
2014,54,Wayne,Urban,Commercial,11,14083,0.781,8,1704,4.695,0,2268,0,8,3972,2.014,19,18055,1.052,0,8414,0,0,13184,0,0,21598,0,19,39653,0.479
2013,,Statewide Total,State,Medicare,481,984820,0.488,1165,668192,1.744,103,245970,0.419,1268,914162,1.387,1749,1898982,0.921,1,658843,0.002,9,2847889,0.003,10,3506732,0.003,1759,5405714,0.325
2015,29,Niagara,Urban,Medicaid,105,25374,4.138,34,3083,11.028,3,2670,1.124,37,5753,6.431,142,31127,4.562,0,4051,0,0,17463,0,0,21514,0,142,52641,2.698
2012,58,Bronx,Urban,Medicaid,79,421838,0.187,293,71513,4.097,35,47667,0.734,328,119180,2.752,407,541018,0.752,0,41370,0,4,953338,0.004,4,994708,0.004,411,1535726,0.268
2015,9,Clinton,Rural,Other,2,1005,1.99,0,150,0,0,65,0,0,215,0,2,1220,1.639,0,380,0,0,570,0,0,950,0,2,2170,0.922
2011,23,Lewis,Rural,Medicaid,0,2491,0,1,146,6.849,1,299,3.344,2,445,4.494,2,2936,0.681,0,310,0,0,1630,0,0,1940,0,2,4876,0.41
2013,9,Clinton,Rural,Medicare,0,6614,0,9,2493,3.61,1,704,1.42,10,3197,3.128,10,9811,1.019,0,3537,0,0,15886,0,0,19423,0,10,29234,0.342
2015,8,Chenango,Rural,Other,1,539,1.855,0,55,0,0,32,0,0,87,0,1,626,1.597,0,91,0,1,385,2.597,1,476,2.101,2,1102,1.815
2014,56,Wyoming,Rural,Other,0,787,0,0,114,0,1,62,16.129,1,176,5.682,1,963,1.038,0,331,0,0,589,0,0,920,0,1,1883,0.531
2015,60,New York (Manhattan),Urban,Medicare,33,85700,0.385,172,47736,3.603,29,15104,1.92,201,62840,3.199,234,148540,1.575,0,48646,0,24,390383,0.061,24,439029,0.055,258,587569,0.439
2013,24,Livingston,Urban,Medicaid,5,4732,1.057,5,360,13.889,0,666,0,5,1026,4.873,10,5758,1.737,0,986,0,1,4444,0.225,1,5430,0.184,11,11188,0.983
2011,60,New York (Manhattan),Urban,Medicaid,80,233407,0.343,147,37181,3.954,15,28297,0.53,162,65478,2.474,242,298885,0.81,0,31459,0,1,555946,0.002,1,587405,0.002,243,886290,0.274
2011,1,Albany,Urban,Commercial,38,40818,0.931,16,5035,3.178,2,5640,0.355,18,10675,1.686,56,51493,1.088,0,21222,0,0,44885,0,0,66107,0,56,117600,0.476
2015,26,Monroe,Urban,Medicare,42,50176,0.837,77,25949,2.967,6,6506,0.922,83,32455,2.557,125,82631,1.513,0,34653,0,0,111906,0,0,146559,0,125,229190,0.545
2011,3,Broome,Urban,Medicaid,28,26604,1.052,12,2223,5.398,1,3005,0.333,13,5228,2.487,41,31832,1.288,0,2207,0,1,35411,0.028,1,37618,0.027,42,69450,0.605
2014,9,Clinton,Rural,Medicare,2,6450,0.31,9,3047,2.954,0,620,0,9,3667,2.454,11,10117,1.087,0,3850,0,0,12974,0,0,16824,0,11,26941,0.408
2014,5,Cayuga,Rural,Medicaid,17,8840,1.923,5,840,5.952,1,990,1.01,6,1830,3.279,23,10670,2.156,0,1781,0,1,7227,0.138,1,9008,0.111,24,19678,1.22
2013,41,Saratoga,Urban,Commercial,20,19161,1.044,11,2768,3.974,3,5631,0.533,14,8399,1.667,34,27560,1.234,0,19953,0,0,26347,0,0,46300,0,34,73860,0.46
2014,35,Oswego,Urban,Medicare,4,6019,0.665,6,4431,1.354,2,1624,1.232,8,6055,1.321,12,12074,0.994,0,6818,0,0,12732,0,0,19550,0,12,31624,0.379
2013,48,Sullivan,Rural,Medicare,6,5716,1.05,8,2807,2.85,0,1042,0,8,3849,2.078,14,9565,1.464,0,2937,0,0,8237,0,0,11174,0,14,20739,0.675
2014,46,Steuben,Rural,Other,0,2099,0,1,161,6.211,0,202,0,1,363,2.755,1,2462,0.406,0,854,0,0,1345,0,0,2199,0,1,4661,0.215
2014,30,Oneida,Urban,Medicare,15,17639,0.85,17,9241,1.84,5,3957,1.264,22,13198,1.667,37,30837,1.2,0,12639,0,1,24136,0.041,1,36775,0.027,38,67612,0.562
2011,50,Tompkins,Urban,Commercial,2,11873,0.168,6,1101,5.45,0,2032,0,6,3133,1.915,8,15006,0.533,0,5330,0,0,7862,0,0,13192,0,8,28198,0.284
2011,46,Steuben,Rural,Medicaid,5,11564,0.432,6,1052,5.703,1,1374,0.728,7,2426,2.885,12,13990,0.858,0,1507,0,0,5611,0,0,7118,0,12,21108,0.569
2013,33,Orange,Urban,Medicare,10,18419,0.543,25,11055,2.261,2,4326,0.462,27,15381,1.755,37,33800,1.095,0,10859,0,0,19660,0,0,30519,0,37,64319,0.575
2015,39,Rockland,Urban,Commercial,17,32320,0.526,9,3876,2.322,0,5232,0,9,9108,0.988,26,41428,0.628,0,8002,0,1,25297,0.04,1,33299,0.03,27,74727,0.361
2014,16,Franklin,Rural,Medicare,1,1986,0.504,2,697,2.869,0,331,0,2,1028,1.946,3,3014,0.995,0,1048,0,0,3120,0,0,4168,0,3,7182,0.418
2011,49,Tioga,Urban,Medicare,1,1316,0.76,6,857,7.001,0,374,0,6,1231,4.874,7,2547,2.748,0,990,0,0,4677,0,0,5667,0,7,8214,0.852
2011,30,Oneida,Urban,Medicaid,16,35658,0.449,28,3367,8.316,5,4216,1.186,33,7583,4.352,49,43241,1.133,0,5233,0,0,15829,0,0,21062,0,49,64303,0.762
2013,28,Nassau,Urban,Medicare,17,52600,0.323,58,53415,1.086,1,16331,0.061,59,69746,0.846,76,122346,0.621,0,42257,0,0,91897,0,0,134154,0,76,256500,0.296
2014,10,Columbia,Rural,Medicare,4,4680,0.855,2,2537,0.788,1,827,1.209,3,3364,0.892,7,8044,0.87,0,2917,0,0,6196,0,0,9113,0,7,17157,0.408
2015,5,Cayuga,Rural,Medicaid,23,10067,2.285,15,793,18.916,4,1219,3.281,19,2012,9.443,42,12079,3.477,0,1837,0,3,7391,0.406,3,9228,0.325,45,21307,2.112
2015,33,Orange,Urban,Medicare,20,19936,1.003,37,12526,2.954,2,3815,0.524,39,16341,2.387,59,36277,1.626,0,11423,0,0,25613,0,0,37036,0,59,73313,0.805
2011,19,Greene,Rural,Medicare,3,2213,1.356,7,2117,3.307,0,637,0,7,2754,2.542,10,4967,2.013,0,1916,0,0,3533,0,0,5449,0,10,10416,0.96
2014,32,Ontario,Urban,Other,12,2339,5.13,2,355,5.634,0,150,0,2,505,3.96,14,2844,4.923,0,751,0,0,615,0,0,1366,0,14,4210,3.325
2014,11,Cortland,Rural,Medicaid,10,9223,1.084,6,600,10,1,641,1.56,7,1241,5.641,17,10464,1.625,0,1026,0,0,2497,0,0,3523,0,17,13987,1.215
2011,11,Cortland,Rural,Medicaid,5,5200,0.962,5,609,8.21,0,737,0,5,1346,3.715,10,6546,1.528,0,594,0,0,1870,0,0,2464,0,10,9010,1.11
2013,34,Orleans,Urban,Medicaid,5,2836,1.763,4,307,13.029,0,522,0,4,829,4.825,9,3665,2.456,0,542,0,0,1484,0,0,2026,0,9,5691,1.581
2015,33,Orange,Urban,Medicaid,60,36252,1.655,35,4411,7.935,0,5850,0,35,10261,3.411,95,46513,2.042,0,5483,0,0,9804,0,0,15287,0,95,61800,1.537
2014,37,Putnam,Urban,Commercial,13,14078,0.923,2,1513,1.322,0,2304,0,2,3817,0.524,15,17895,0.838,0,6103,0,0,10704,0,0,16807,0,15,34702,0.432
2012,49,Tioga,Urban,Commercial,5,3703,1.35,2,449,4.454,0,747,0,2,1196,1.672,7,4899,1.429,0,1995,0,0,4296,0,0,6291,0,7,11190,0.626
2014,46,Steuben,Rural,Commercial,13,14547,0.894,5,924,5.411,1,2097,0.477,6,3021,1.986,19,17568,1.082,0,5860,0,0,24350,0,0,30210,0,19,47778,0.398
2014,37,Putnam,Urban,Medicaid,6,3939,1.523,6,442,13.575,0,609,0,6,1051,5.709,12,4990,2.405,0,472,0,0,2908,0,0,3380,0,12,8370,1.434
2014,55,Westchester,Urban,Medicare,15,43127,0.348,47,29306,1.604,13,12372,1.051,60,41678,1.44,75,84805,0.884,0,27482,0,6,113976,0.053,6,141458,0.042,81,226263,0.358
2013,46,Steuben,Rural,Commercial,9,18050,0.499,4,1310,3.053,2,2256,0.887,6,3566,1.683,15,21616,0.694,0,6920,0,0,18459,0,0,25379,0,15,46995,0.319
2014,88,Other than New York State,Urban,Medicare,10,16111,0.621,18,8358,2.154,4,9791,0.409,22,18149,1.212,32,34260,0.934,0,16011,0,0,41231,0,0,57242,0,32,91502,0.35
2014,52,Warren,Urban,Medicare,1,5468,0.183,4,2805,1.426,0,1064,0,4,3869,1.034,5,9337,0.536,0,4363,0,0,10854,0,0,15217,0,5,24554,0.204
2010,46,Steuben,Rural,Medicaid,3,7970,0.376,1,1015,0.985,3,1442,2.08,4,2457,1.628,7,10427,0.671,0,1182,0,0,74,0,0,1256,0,7,11683,0.599
2011,29,Niagara,Urban,Medicaid,23,21746,1.058,38,3013,12.612,1,2584,0.387,39,5597,6.968,62,27343,2.267,0,3135,0,0,13386,0,0,16521,0,62,43864,1.413
2012,38,Rensselaer,Urban,Medicaid,13,17347,0.749,7,2054,3.408,0,1858,0,7,3912,1.789,20,21259,0.941,0,1903,0,0,4957,0,0,6860,0,20,28119,0.711
2015,21,Herkimer,Urban,Other,1,472,2.119,0,34,0,0,36,0,0,70,0,1,542,1.845,0,83,0,0,676,0,0,759,0,1,1301,0.769
2015,52,Warren,Urban,Other,0,610,0,0,54,0,0,57,0,0,111,0,0,721,0,0,137,0,0,306,0,0,443,0,0,1164,0
2014,,Statewide Total,State,Medicaid,2085,2741734,0.76,1745,389328,4.482,213,325249,0.655,1958,714577,2.74,4043,3456311,1.17,5,356423,0.014,22,4592899,0.005,27,4949322,0.005,4070,8405633,0.484
2012,22,Jefferson,Urban,Commercial,9,19217,0.468,5,1339,3.734,0,2164,0,5,3503,1.427,14,22720,0.616,0,5661,0,0,9515,0,0,15176,0,14,37896,0.369
2010,13,Dutchess,Urban,Commercial,34,40701,0.835,15,2893,5.185,8,10402,0.769,23,13295,1.73,57,53996,1.056,0,15327,0,0,19,0,0,15346,0,57,69342,0.822
2013,28,Nassau,Urban,Medicaid,76,79219,0.959,78,15551,5.016,3,12006,0.25,81,27557,2.939,157,106776,1.47,0,10669,0,0,116862,0,0,127531,0,157,234307,0.67
2013,59,Kings (Brooklyn),Urban,Medicaid,147,409663,0.359,202,77725,2.599,38,60136,0.632,240,137861,1.741,387,547524,0.707,0,51278,0,1,1019808,0.001,1,1071086,0.001,388,1618610,0.24
2013,52,Warren,Urban,Commercial,4,7824,0.511,10,1118,8.945,0,1344,0,10,2462,4.062,14,10286,1.361,0,4334,0,0,7338,0,0,11672,0,14,21958,0.638
2013,56,Wyoming,Rural,Medicaid,1,3213,0.311,3,214,14.019,1,305,3.279,4,519,7.707,5,3732,1.34,0,680,0,0,1409,0,0,2089,0,5,5821,0.859
2014,24,Livingston,Urban,Medicare,6,3387,1.771,7,1784,3.924,2,627,3.19,9,2411,3.733,15,5798,2.587,0,3202,0,0,7448,0,0,10650,0,15,16448,0.912
2014,60,New York (Manhattan),Urban,Medicaid,87,256236,0.34,159,34933,4.552,24,24195,0.992,183,59128,3.095,270,315364,0.856,0,23178,0,0,613164,0,0,636342,0,270,951706,0.284
2014,46,Steuben,Rural,Medicaid,8,13020,0.614,5,720,6.944,0,1380,0,5,2100,2.381,13,15120,0.86,0,2016,0,0,8714,0,0,10730,0,13,25850,0.503
2014,20,Hamilton,Rural,Medicare,0,308,0,0,146,0,0,101,0,0,247,0,0,555,0,0,350,0,0,670,0,0,1020,0,0,1575,0
2012,54,Wayne,Urban,Medicare,4,5894,0.679,10,3539,2.826,1,1328,0.753,11,4867,2.26,15,10761,1.394,0,3860,0,0,10095,0,0,13955,0,15,24716,0.607
2013,42,Schenectady,Urban,Commercial,16,26269,0.609,2,956,2.092,8,5042,1.587,10,5998,1.667,26,32267,0.806,0,13426,0,0,22509,0,0,35935,0,26,68202,0.381
2012,29,Niagara,Urban,Other,0,2669,0,4,300,13.333,0,296,0,4,596,6.711,4,3265,1.225,0,597,0,0,1236,0,0,1833,0,4,5098,0.785
2015,50,Tompkins,Urban,Medicaid,15,5529,2.713,6,623,9.631,0,724,0,6,1347,4.454,21,6876,3.054,0,845,0,0,7708,0,0,8553,0,21,15429,1.361
2014,61,Queens,Urban,Commercial,75,305880,0.245,40,28820,1.388,11,39611,0.278,51,68431,0.745,126,374311,0.337,0,74212,0,0,472377,0,0,546589,0,126,920900,0.137
2015,34,Orleans,Urban,Other,0,577,0,0,61,0,0,46,0,0,107,0,0,684,0,0,317,0,0,613,0,0,930,0,0,1614,0
2014,99,Unknown,Urban,Medicaid,44,48833,0.901,29,7112,4.078,2,3852,0.519,31,10964,2.827,75,59797,1.254,0,15636,0,0,39093,0,0,54729,0,75,114526,0.655
2012,34,Orleans,Urban,Medicaid,1,2988,0.335,0,367,0,1,476,2.101,1,843,1.186,2,3831,0.522,0,463,0,0,1381,0,0,1844,0,2,5675,0.352
2015,,Statewide Total,State,Medicare,681,1073379,0.634,1627,637051,2.554,359,225581,1.591,1986,862632,2.302,2667,1936011,1.378,9,683905,0.013,67,2953967,0.023,76,3637872,0.021,2743,5573883,0.492
2014,47,Suffolk,Urban,Commercial,348,229228,1.518,144,36498,3.945,10,33156,0.302,154,69654,2.211,502,298882,1.68,0,103355,0,3,109335,0.027,3,212690,0.014,505,511572,0.987
2011,40,St. Lawrence,Rural,Commercial,2,26567,0.075,2,1807,1.107,0,2200,0,2,4007,0.499,4,30574,0.131,0,7087,0,0,24613,0,0,31700,0,4,62274,0.064
2012,29,Niagara,Urban,Medicare,8,13101,0.611,31,8733,3.55,0,3467,0,31,12200,2.541,39,25301,1.541,0,11580,0,0,26744,0,0,38324,0,39,63625,0.613
2012,40,St. Lawrence,Rural,Commercial,5,25407,0.197,5,1732,2.887,0,2366,0,5,4098,1.22,10,29505,0.339,0,7539,0,0,14750,0,0,22289,0,10,51794,0.193
2013,2,Allegany,Rural,Commercial,3,8694,0.345,1,432,2.315,0,839,0,1,1271,0.787,4,9965,0.401,0,2408,0,0,8482,0,0,10890,0,4,20855,0.192
2013,47,Suffolk,Urban,Commercial,336,240075,1.4,167,40883,4.085,7,34616,0.202,174,75499,2.305,510,315574,1.616,0,104002,0,5,102948,0.049,5,206950,0.024,515,522524,0.986
2015,50,Tompkins,Urban,Commercial,9,9016,0.998,9,937,9.605,0,1593,0,9,2530,3.557,18,11546,1.559,0,4793,0,0,17927,0,0,22720,0,18,34266,0.525
2011,3,Broome,Urban,Commercial,26,24367,1.067,11,2445,4.499,1,3889,0.257,12,6334,1.895,38,30701,1.238,0,11277,0,0,26689,0,0,37966,0,38,68667,0.553
2014,26,Monroe,Urban,Medicare,27,47494,0.568,60,25638,2.34,3,6787,0.442,63,32425,1.943,90,79919,1.126,0,35175,0,0,91104,0,0,126279,0,90,206198,0.436
2015,18,Genesee,Rural,Medicaid,11,5573,1.974,10,514,19.455,0,626,0,10,1140,8.772,21,6713,3.128,0,1098,0,0,8123,0,0,9221,0,21,15934,1.318
2015,33,Orange,Urban,Commercial,86,55294,1.555,35,6862,5.101,9,8461,1.064,44,15323,2.872,130,70617,1.841,0,20836,0,1,30340,0.033,1,51176,0.02,131,121793,1.076
2012,58,Bronx,Urban,Other,2,14943,0.134,3,1726,1.738,1,662,1.511,4,2388,1.675,6,17331,0.346,0,3013,0,0,38582,0,0,41595,0,6,58926,0.102
2015,21,Herkimer,Urban,Commercial,5,5614,0.891,1,468,2.137,0,998,0,1,1466,0.682,6,7080,0.847,0,3759,0,0,12238,0,0,15997,0,6,23077,0.26
2012,61,Queens,Urban,Commercial,71,334972,0.212,56,39708,1.41,7,43561,0.161,63,83269,0.757,134,418241,0.32,0,71886,0,1,495480,0.002,1,567366,0.002,135,985607,0.137
2013,32,Ontario,Urban,Medicaid,7,8386,0.835,10,638,15.674,0,1079,0,10,1717,5.824,17,10103,1.683,0,1539,0,0,4485,0,0,6024,0,17,16127,1.054
2014,23,Lewis,Rural,Commercial,2,4402,0.454,1,330,3.03,0,673,0,1,1003,0.997,3,5405,0.555,0,1702,0,0,2403,0,0,4105,0,3,9510,0.315
2014,7,Chemung,Urban,Other,1,914,1.094,0,157,0,0,96,0,0,253,0,1,1167,0.857,0,404,0,0,3234,0,0,3638,0,1,4805,0.208
2012,15,Essex,Rural,Commercial,4,7591,0.527,2,483,4.141,0,698,0,2,1181,1.693,6,8772,0.684,0,2190,0,0,7657,0,0,9847,0,6,18619,0.322
2015,60,New York (Manhattan),Urban,Other,1,6816,0.147,2,944,2.119,1,604,1.656,3,1548,1.938,4,8364,0.478,0,3537,0,0,12462,0,0,15999,0,4,24363,0.164
2014,11,Cortland,Rural,Other,0,429,0,1,39,25.641,0,23,0,1,62,16.129,1,491,2.037,0,85,0,0,191,0,0,276,0,1,767,1.304
2014,59,Kings (Brooklyn),Urban,Medicaid,172,438828,0.392,224,79668,2.812,30,61108,0.491,254,140776,1.804,426,579604,0.735,0,57173,0,1,1056473,0.001,1,1113646,0.001,427,1693250,0.252
2012,56,Wyoming,Rural,Other,1,739,1.353,1,155,6.452,0,95,0,1,250,4,2,989,2.022,0,283,0,0,312,0,0,595,0,2,1584,1.263
2013,28,Nassau,Urban,Commercial,110,160319,0.686,103,28237,3.648,7,35408,0.198,110,63645,1.728,220,223964,0.982,0,72043,0,0,150289,0,0,222332,0,220,446296,0.493
2012,37,Putnam,Urban,Medicaid,5,2777,1.801,2,334,5.988,0,484,0,2,818,2.445,7,3595,1.947,0,344,0,0,2509,0,0,2853,0,7,6448,1.086
2011,43,Schoharie,Urban,Medicare,1,2738,0.365,1,687,1.456,3,713,4.208,4,1400,2.857,5,4138,1.208,0,2259,0,1,23931,0.042,1,26190,0.038,6,30328,0.198
2012,3,Broome,Urban,Medicaid,36,26943,1.336,21,2379,8.827,1,2972,0.336,22,5351,4.111,58,32294,1.796,0,2260,0,0,40759,0,0,43019,0,58,75313,0.77
2013,60,New York (Manhattan),Urban,Medicaid,76,247618,0.307,152,36141,4.206,29,24903,1.165,181,61044,2.965,257,308662,0.833,0,21993,0,6,605913,0.01,6,627906,0.01,263,936568,0.281
2010,55,Westchester,Urban,Commercial,28,91004,0.308,28,14351,1.951,4,20091,0.199,32,34442,0.929,60,125446,0.478,0,38460,0,0,41,0,0,38501,0,60,163947,0.366
2015,44,Schuyler,Rural,Medicaid,3,2750,1.091,0,124,0,0,219,0,0,343,0,3,3093,0.97,0,353,0,0,5193,0,0,5546,0,3,8639,0.347
2012,11,Cortland,Rural,Other,1,456,2.193,2,118,16.949,0,47,0,2,165,12.121,3,621,4.831,0,94,0,0,160,0,0,254,0,3,875,3.429
2011,19,Greene,Rural,Commercial,3,5577,0.538,3,923,3.25,0,906,0,3,1829,1.64,6,7406,0.81,0,3030,0,0,4308,0,0,7338,0,6,14744,0.407
2012,15,Essex,Rural,Medicare,0,4005,0,1,996,1.004,0,714,0,1,1710,0.585,1,5715,0.175,0,1826,0,0,6708,0,0,8534,0,1,14249,0.07
2010,1,Albany,Urban,Commercial,20,38763,0.516,7,5110,1.37,2,6625,0.302,9,11735,0.767,29,50498,0.574,1,23571,0.042,0,44,0,1,23615,0.042,30,74113,0.405
2013,37,Putnam,Urban,Commercial,19,14501,1.31,11,1709,6.437,2,2394,0.835,13,4103,3.168,32,18604,1.72,0,6167,0,0,11732,0,0,17899,0,32,36503,0.877
2012,4,Cattaraugus,Rural,Medicare,2,2063,0.969,1,998,1.002,0,949,0,1,1947,0.514,3,4010,0.748,0,2097,0,0,4167,0,0,6264,0,3,10274,0.292
2013,6,Chautauqua,Rural,Medicare,10,10715,0.933,8,4082,1.96,1,1337,0.748,9,5419,1.661,19,16134,1.178,0,4775,0,0,18258,0,0,23033,0,19,39167,0.485
2013,17,Fulton,Rural,Other,1,817,1.224,0,56,0,0,54,0,0,110,0,1,927,1.079,0,193,0,0,498,0,0,691,0,1,1618,0.618
2012,33,Orange,Urban,Medicaid,45,38037,1.183,31,4160,7.452,4,6258,0.639,35,10418,3.36,80,48455,1.651,0,4776,0,0,9156,0,0,13932,0,80,62387,1.282
2014,21,Herkimer,Urban,Commercial,4,6365,0.628,2,615,3.252,0,1116,0,2,1731,1.155,6,8096,0.741,0,4075,0,0,12018,0,0,16093,0,6,24189,0.248
2012,10,Columbia,Rural,Medicare,1,4402,0.227,1,2829,0.353,1,817,1.224,2,3646,0.549,3,8048,0.373,0,2675,0,0,5776,0,0,8451,0,3,16499,0.182
2013,56,Wyoming,Rural,Medicare,1,2081,0.481,4,1197,3.342,0,662,0,4,1859,2.152,5,3940,1.269,0,1953,0,0,2775,0,0,4728,0,5,8668,0.577
2013,,Statewide Total,State,Medicaid,1579,2551987,0.619,1686,381115,4.424,199,317658,0.626,1885,698773,2.698,3464,3250760,1.066,1,312106,0.003,25,4481265,0.006,26,4793371,0.005,3490,8044131,0.434
2012,26,Monroe,Urban,Medicaid,56,79524,0.704,53,9393,5.642,0,9868,0,53,19261,2.752,109,98785,1.103,0,9705,0,0,64053,0,0,73758,0,109,172543,0.632
2015,60,New York (Manhattan),Urban,Medicaid,103,266392,0.387,198,33929,5.836,23,23354,0.985,221,57283,3.858,324,323675,1.001,0,24054,0,13,600664,0.022,13,624718,0.021,337,948393,0.355
2015,55,Westchester,Urban,Medicaid,64,101305,0.632,59,12606,4.68,9,13631,0.66,68,26237,2.592,132,127542,1.035,0,10124,0,1,162661,0.006,1,172785,0.006,133,300327,0.443
2012,46,Steuben,Rural,Commercial,12,19462,0.617,6,1426,4.208,0,2388,0,6,3814,1.573,18,23276,0.773,0,7102,0,0,12199,0,0,19301,0,18,42577,0.423
2013,1,Albany,Urban,Commercial,21,34862,0.602,14,4200,3.333,3,6013,0.499,17,10213,1.665,38,45075,0.843,0,21795,0,0,43818,0,0,65613,0,38,110688,0.343
2012,,Statewide Total,State,Medicaid,1165,2507522,0.465,1609,388838,4.138,182,324883,0.56,1791,713721,2.509,2956,3221243,0.918,0,286036,0,10,4334991,0.002,10,4621027,0.002,2966,7842270,0.378
2015,55,Westchester,Urban,Medicare,18,43425,0.415,56,30800,1.818,5,10868,0.46,61,41668,1.464,79,85093,0.928,0,26109,0,5,126963,0.039,5,153072,0.033,84,238165,0.353
2014,18,Genesee,Rural,Other,2,764,2.618,0,88,0,0,48,0,0,136,0,2,900,2.222,0,206,0,0,641,0,0,847,0,2,1747,1.145
2012,43,Schoharie,Urban,Commercial,3,5447,0.551,1,316,3.165,1,639,1.565,2,955,2.094,5,6402,0.781,0,2021,0,0,6270,0,0,8291,0,5,14693,0.34
2012,28,Nassau,Urban,Medicaid,32,66185,0.483,55,14326,3.839,5,10380,0.482,60,24706,2.429,92,90891,1.012,0,8611,0,1,102042,0.01,1,110653,0.009,93,201544,0.461
2012,1,Albany,Urban,Medicaid,32,37923,0.844,9,3898,2.309,1,3524,0.284,10,7422,1.347,42,45345,0.926,0,3668,0,1,21179,0.047,1,24847,0.04,43,70192,0.613
2014,2,Allegany,Rural,Medicaid,4,6369,0.628,5,253,19.763,1,503,1.988,6,756,7.937,10,7125,1.404,0,698,0,0,4742,0,0,5440,0,10,12565,0.796
2010,60,New York (Manhattan),Urban,Commercial,71,199716,0.356,58,27999,2.072,7,34609,0.202,65,62608,1.038,136,262324,0.518,0,78424,0,0,152,0,0,78576,0,136,340900,0.399
2015,56,Wyoming,Rural,Commercial,6,5247,1.144,3,491,6.11,0,997,0,3,1488,2.016,9,6735,1.336,0,3159,0,0,6041,0,0,9200,0,9,15935,0.565
2015,15,Essex,Rural,Medicare,1,4511,0.222,2,851,2.35,0,663,0,2,1514,1.321,3,6025,0.498,0,1500,0,0,7658,0,0,9158,0,3,15183,0.198
2013,25,Madison,Urban,Medicaid,5,8773,0.57,4,445,8.989,1,791,1.264,5,1236,4.045,10,10009,0.999,0,1248,0,0,5304,0,0,6552,0,10,16561,0.604
2015,58,Bronx,Urban,Other,1,13215,0.076,5,1466,3.411,2,681,2.937,7,2147,3.26,8,15362,0.521,0,3246,0,0,32391,0,0,35637,0,8,50999,0.157
2011,6,Chautauqua,Rural,Medicaid,9,20632,0.436,9,1776,5.068,1,2055,0.487,10,3831,2.61,19,24463,0.777,0,2539,0,0,19112,0,0,21651,0,19,46114,0.412
2014,27,Montgomery,Rural,Commercial,1,11672,0.086,2,585,3.419,1,1049,0.953,3,1634,1.836,4,13306,0.301,0,4260,0,0,15545,0,0,19805,0,4,33111,0.121
2012,62,Richmond (Staten Island),Urban,Commercial,39,68044,0.573,50,12382,4.038,2,10500,0.19,52,22882,2.273,91,90926,1.001,0,20718,0,0,73631,0,0,94349,0,91,185275,0.491
2013,1,Albany,Urban,Medicare,8,16874,0.474,14,9958,1.406,0,2931,0,14,12889,1.086,22,29763,0.739,0,12928,0,0,29525,0,0,42453,0,22,72216,0.305
2010,55,Westchester,Urban,Other,0,6889,0,3,1370,2.19,0,643,0,3,2013,1.49,3,8902,0.337,0,1261,0,0,0,0,0,1261,0,3,10163,0.295
2015,56,Wyoming,Rural,Medicaid,9,2941,3.06,1,285,3.509,1,356,2.809,2,641,3.12,11,3582,3.071,0,659,0,0,1623,0,0,2282,0,11,5864,1.876
2011,18,Genesee,Rural,Medicare,4,3586,1.115,7,2670,2.622,0,917,0,7,3587,1.951,11,7173,1.534,0,2675,0,0,7179,0,0,9854,0,11,17027,0.646
2011,49,Tioga,Urban,Commercial,2,3878,0.516,0,497,0,1,780,1.282,1,1277,0.783,3,5155,0.582,0,2140,0,0,3631,0,0,5771,0,3,10926,0.275
2011,29,Niagara,Urban,Medicare,5,12467,0.401,28,9284,3.016,0,3386,0,28,12670,2.21,33,25137,1.313,0,11285,0,0,26255,0,0,37540,0,33,62677,0.527
2015,28,Nassau,Urban,Medicare,31,59895,0.518,95,48383,1.963,30,17126,1.752,125,65509,1.908,156,125404,1.244,0,43704,0,1,124644,0.008,1,168348,0.006,157,293752,0.534
2010,88,Other than New York State,Urban,Medicare,5,9682,0.516,4,6748,0.593,1,8641,0.116,5,15389,0.325,10,25071,0.399,0,13048,0,0,74,0,0,13122,0,10,38193,0.262
2015,41,Saratoga,Urban,Commercial,31,14588,2.125,4,2401,1.666,8,4911,1.629,12,7312,1.641,43,21900,1.963,0,18798,0,0,38002,0,0,56800,0,43,78700,0.546
2013,38,Rensselaer,Urban,Other,1,1906,0.525,0,162,0,0,101,0,0,263,0,1,2169,0.461,0,241,0,0,1895,0,0,2136,0,1,4305,0.232
2011,21,Herkimer,Urban,Medicare,2,4260,0.469,3,2677,1.121,0,1265,0,3,3942,0.761,5,8202,0.61,0,4428,0,0,27088,0,0,31516,0,5,39718,0.126
2014,16,Franklin,Rural,Commercial,1,3189,0.314,2,285,7.018,0,482,0,2,767,2.608,3,3956,0.758,0,1525,0,0,3773,0,0,5298,0,3,9254,0.324
2012,54,Wayne,Urban,Commercial,5,14613,0.342,4,1714,2.334,1,2548,0.392,5,4262,1.173,10,18875,0.53,0,6954,0,0,11739,0,0,18693,0,10,37568,0.266
2013,3,Broome,Urban,Medicaid,48,25631,1.873,18,2403,7.491,2,2987,0.67,20,5390,3.711,68,31021,2.192,1,2241,0.446,0,49628,0,1,51869,0.019,69,82890,0.832
2015,62,Richmond (Staten Island),Urban,Other,0,6670,0,2,601,3.328,0,235,0,2,836,2.392,2,7506,0.266,0,925,0,0,24953,0,0,25878,0,2,33384,0.06
2011,18,Genesee,Rural,Medicaid,3,5419,0.554,2,512,3.906,0,637,0,2,1149,1.741,5,6568,0.761,0,664,0,0,6712,0,0,7376,0,5,13944,0.359
2015,35,Oswego,Urban,Other,1,1105,0.905,0,142,0,0,117,0,0,259,0,1,1364,0.733,0,380,0,0,491,0,0,871,0,1,2235,0.447
2015,57,Yates,Urban,Other,0,392,0,0,39,0,0,51,0,0,90,0,0,482,0,0,106,0,0,188,0,0,294,0,0,776,0
2012,24,Livingston,Urban,Medicaid,4,5049,0.792,3,415,7.229,0,622,0,3,1037,2.893,7,6086,1.15,0,862,0,0,3459,0,0,4321,0,7,10407,0.673
2012,34,Orleans,Urban,Other,0,622,0,0,82,0,0,37,0,0,119,0,0,741,0,0,159,0,0,278,0,0,437,0,0,1178,0
2015,43,Schoharie,Urban,Medicare,5,2834,1.764,1,744,1.344,0,711,0,1,1455,0.687,6,4289,1.399,0,1578,0,0,17289,0,0,18867,0,6,23156,0.259
2014,30,Oneida,Urban,Medicaid,43,35220,1.221,38,2991,12.705,8,4313,1.855,46,7304,6.298,89,42524,2.093,0,5118,0,2,20244,0.099,2,25362,0.079,91,67886,1.34
2013,60,New York (Manhattan),Urban,Medicare,14,67967,0.206,114,49526,2.302,15,20327,0.738,129,69853,1.847,143,137820,1.038,0,48436,0,1,385241,0.003,1,433677,0.002,144,571497,0.252
2014,88,Other than New York State,Urban,Commercial,64,68590,0.933,28,9632,2.907,7,19884,0.352,35,29516,1.186,99,98106,1.009,0,40232,0,1,73045,0.014,1,113277,0.009,100,211383,0.473
2015,29,Niagara,Urban,Other,5,2029,2.464,0,170,0,0,305,0,0,475,0,5,2504,1.997,0,635,0,0,1138,0,0,1773,0,5,4277,1.169
2014,59,Kings (Brooklyn),Urban,Other,2,18489,0.108,4,1929,2.074,2,995,2.01,6,2924,2.052,8,21413,0.374,0,4738,0,0,24393,0,0,29131,0,8,50544,0.158
2014,1,Albany,Urban,Unknown,0,11,0,0,0,0,0,1,0,0,1,0,0,12,0,0,2,0,0,0,0,0,2,0,0,14,0
2014,61,Queens,Urban,Other,6,18114,0.331,9,2778,3.24,2,1380,1.449,11,4158,2.646,17,22272,0.763,0,6879,0,0,42174,0,0,49053,0,17,71325,0.238
2010,45,Seneca,Rural,Commercial,3,4602,0.652,1,425,2.353,0,809,0,1,1234,0.81,4,5836,0.685,0,2610,0,0,46,0,0,2656,0,4,8492,0.471
2015,27,Montgomery,Rural,Medicaid,8,13347,0.599,10,817,12.24,1,1055,0.948,11,1872,5.876,19,15219,1.248,0,1743,0,0,16683,0,0,18426,0,19,33645,0.565
2011,,Statewide Total,State,Other,64,219616,0.291,92,28225,3.26,11,16909,0.651,103,45134,2.282,167,264750,0.631,0,47459,0,1,269370,0.004,1,316829,0.003,168,581579,0.289
2015,25,Madison,Urban,Medicaid,21,9409,2.232,3,535,5.607,0,876,0,3,1411,2.126,24,10820,2.218,0,1742,0,0,3019,0,0,4761,0,24,15581,1.54
2013,50,Tompkins,Urban,Medicaid,5,6188,0.808,7,538,13.011,1,629,1.59,8,1167,6.855,13,7355,1.768,0,804,0,0,5508,0,0,6312,0,13,13667,0.951
2013,2,Allegany,Rural,Other,0,544,0,0,52,0,0,43,0,0,95,0,0,639,0,0,110,0,0,990,0,0,1100,0,0,1739,0
2012,99,Unknown,Urban,Other,3,10377,0.289,2,591,3.384,0,385,0,2,976,2.049,5,11353,0.44,0,3204,0,0,3944,0,0,7148,0,5,18501,0.27
2014,23,Lewis,Rural,Other,0,535,0,0,40,0,0,61,0,0,101,0,0,636,0,0,129,0,0,265,0,0,394,0,0,1030,0
2014,37,Putnam,Urban,Other,0,945,0,0,69,0,0,41,0,0,110,0,0,1055,0,0,445,0,0,446,0,0,891,0,0,1946,0
2015,38,Rensselaer,Urban,Other,2,1109,1.803,0,80,0,0,99,0,0,179,0,2,1288,1.553,0,231,0,0,1035,0,0,1266,0,2,2554,0.783
2015,48,Sullivan,Rural,Other,1,1138,0.879,0,160,0,0,54,0,0,214,0,1,1352,0.74,0,318,0,0,525,0,0,843,0,1,2195,0.456
2011,5,Cayuga,Rural,Medicaid,2,6448,0.31,2,589,3.396,2,1134,1.764,4,1723,2.322,6,8171,0.734,0,1014,0,2,5802,0.345,2,6816,0.293,8,14987,0.534
2014,50,Tompkins,Urban,Other,0,523,0,0,47,0,0,33,0,0,80,0,0,603,0,0,114,0,0,476,0,0,590,0,0,1193,0
2014,17,Fulton,Rural,Medicaid,3,11354,0.264,4,831,4.813,0,943,0,4,1774,2.255,7,13128,0.533,0,1822,0,0,6265,0,0,8087,0,7,21215,0.33
2012,30,Oneida,Urban,Commercial,16,33661,0.475,12,3600,3.333,2,5022,0.398,14,8622,1.624,30,42283,0.71,0,18399,0,1,19920,0.05,1,38319,0.026,31,80602,0.385
2012,34,Orleans,Urban,Medicare,0,2462,0,3,1526,1.966,0,737,0,3,2263,1.326,3,4725,0.635,0,1965,0,0,3371,0,0,5336,0,3,10061,0.298
2012,22,Jefferson,Urban,Medicare,1,7142,0.14,3,2858,1.05,1,1642,0.609,4,4500,0.889,5,11642,0.429,0,3753,0,0,10341,0,0,14094,0,5,25736,0.194
2013,31,Onondaga,Urban,Commercial,97,55283,1.755,40,6746,5.929,1,11771,0.085,41,18517,2.214,138,73800,1.87,0,32195,0,0,33125,0,0,65320,0,138,139120,0.992
2014,39,Rockland,Urban,Other,2,2450,0.816,0,178,0,0,91,0,0,269,0,2,2719,0.736,0,152,0,0,1199,0,0,1351,0,2,4070,0.491
2011,62,Richmond (Staten Island),Urban,Medicare,6,16953,0.354,41,18878,2.172,1,5353,0.187,42,24231,1.733,48,41184,1.166,0,11631,0,0,95942,0,0,107573,0,48,148757,0.323
2014,29,Niagara,Urban,Other,1,2125,0.471,0,180,0,0,281,0,0,461,0,1,2586,0.387,0,672,0,0,1397,0,0,2069,0,1,4655,0.215
2015,28,Nassau,Urban,Commercial,128,157440,0.813,81,23628,3.428,22,33993,0.647,103,57621,1.788,231,215061,1.074,0,70584,0,0,169653,0,0,240237,0,231,455298,0.507
2014,50,Tompkins,Urban,Medicaid,20,6487,3.083,16,625,25.6,2,744,2.688,18,1369,13.148,38,7856,4.837,0,845,0,0,6274,0,0,7119,0,38,14975,2.538
2011,8,Chenango,Rural,Medicaid,0,8352,0,3,430,6.977,0,853,0,3,1283,2.338,3,9635,0.311,0,831,0,0,31481,0,0,32312,0,3,41947,0.072
2014,88,Other than New York State,Urban,Medicaid,10,10182,0.982,13,1605,8.1,3,963,3.115,16,2568,6.231,26,12750,2.039,0,661,0,0,4037,0,0,4698,0,26,17448,1.49
2015,27,Montgomery,Rural,Commercial,6,12078,0.497,6,699,8.584,1,1037,0.964,7,1736,4.032,13,13814,0.941,0,3969,0,0,15054,0,0,19023,0,13,32837,0.396
2010,47,Suffolk,Urban,Commercial,192,240813,0.797,166,47961,3.461,10,45992,0.217,176,93953,1.873,368,334766,1.099,0,76293,0,0,337,0,0,76630,0,368,411396,0.895
2012,59,Kings (Brooklyn),Urban,Medicaid,123,415454,0.296,204,87313,2.336,26,61925,0.42,230,149238,1.541,353,564692,0.625,0,51646,0,0,1055751,0,0,1107397,0,353,1672089,0.211
2015,62,Richmond (Staten Island),Urban,Commercial,57,57846,0.985,32,9664,3.311,6,6858,0.875,38,16522,2.3,95,74368,1.277,3,19216,0.156,1,70541,0.014,4,89757,0.045,99,164125,0.603
2014,48,Sullivan,Rural,Medicare,6,6124,0.98,11,2847,3.864,0,939,0,11,3786,2.905,17,9910,1.715,0,3077,0,0,7675,0,0,10752,0,17,20662,0.823
2013,25,Madison,Urban,Commercial,15,9767,1.536,4,855,4.678,1,1574,0.635,5,2429,2.058,20,12196,1.64,0,5523,0,0,6796,0,0,12319,0,20,24515,0.816
2012,14,Erie,Urban,Medicare,34,55209,0.616,92,34565,2.662,4,10781,0.371,96,45346,2.117,130,100555,1.293,0,35802,0,0,69568,0,0,105370,0,130,205925,0.631
2013,39,Rockland,Urban,Medicaid,7,22254,0.315,7,3233,2.165,3,7474,0.401,10,10707,0.934,17,32961,0.516,0,3166,0,0,18586,0,0,21752,0,17,54713,0.311
2014,49,Tioga,Urban,Other,2,149,13.423,0,26,0,0,27,0,0,53,0,2,202,9.901,0,40,0,0,299,0,0,339,0,2,541,3.697
2011,32,Ontario,Urban,Medicare,7,6991,1.001,12,3806,3.153,0,1367,0,12,5173,2.32,19,12164,1.562,0,5326,0,0,13548,0,0,18874,0,19,31038,0.612
2013,58,Bronx,Urban,Medicare,26,69097,0.376,94,50080,1.877,1,12672,0.079,95,62752,1.514,121,131849,0.918,0,34303,0,0,329151,0,0,363454,0,121,495303,0.244
2012,53,Washington,Urban,Medicaid,0,5150,0,3,587,5.111,1,782,1.279,4,1369,2.922,4,6519,0.614,0,1152,0,0,2439,0,0,3591,0,4,10110,0.396
2011,22,Jefferson,Urban,Medicare,2,7248,0.276,2,2894,0.691,1,1714,0.583,3,4608,0.651,5,11856,0.422,0,3838,0,0,10011,0,0,13849,0,5,25705,0.195
2011,48,Sullivan,Rural,Other,3,3955,0.759,3,365,8.219,0,99,0,3,464,6.466,6,4419,1.358,0,323,0,0,1120,0,0,1443,0,6,5862,1.024
2014,48,Sullivan,Rural,Medicaid,9,4822,1.866,7,871,8.037,1,863,1.159,8,1734,4.614,17,6556,2.593,0,1069,0,0,2356,0,0,3425,0,17,9981,1.703
2015,28,Nassau,Urban,Other,1,9627,0.104,7,1101,6.358,2,424,4.717,9,1525,5.902,10,11152,0.897,0,3274,0,0,5777,0,0,9051,0,10,20203,0.495
2012,16,Franklin,Rural,Medicare,1,1742,0.574,2,753,2.656,0,358,0,2,1111,1.8,3,2853,1.052,0,1058,0,0,2592,0,0,3650,0,3,6503,0.461
2014,14,Erie,Urban,Other,5,12114,0.413,2,1018,1.965,1,1527,0.655,3,2545,1.179,8,14659,0.546,0,3565,0,0,7744,0,0,11309,0,8,25968,0.308
2011,36,Otsego,Rural,Medicare,2,4150,0.482,5,2076,2.408,2,1042,1.919,7,3118,2.245,9,7268,1.238,0,6134,0,0,62439,0,0,68573,0,9,75841,0.119
2014,29,Niagara,Urban,Medicare,11,14523,0.757,23,7436,3.093,0,3124,0,23,10560,2.178,34,25083,1.355,0,11003,0,0,27651,0,0,38654,0,34,63737,0.533
2013,13,Dutchess,Urban,Commercial,58,42932,1.351,27,4693,5.753,3,7259,0.413,30,11952,2.51,88,54884,1.603,0,16020,0,1,25602,0.039,1,41622,0.024,89,96506,0.922
2011,38,Rensselaer,Urban,Commercial,12,20392,0.588,8,2930,2.73,0,3356,0,8,6286,1.273,20,26678,0.75,0,10716,0,0,14915,0,0,25631,0,20,52309,0.382
2013,35,Oswego,Urban,Commercial,18,12844,1.401,8,1794,4.459,2,2992,0.668,10,4786,2.089,28,17630,1.588,0,8948,0,0,10735,0,0,19683,0,28,37313,0.75
2014,24,Livingston,Urban,Commercial,9,5852,1.538,3,717,4.184,0,1242,0,3,1959,1.531,12,7811,1.536,0,4424,0,0,11406,0,0,15830,0,12,23641,0.508
2012,60,New York (Manhattan),Urban,Commercial,62,230242,0.269,63,27828,2.264,17,36495,0.466,80,64323,1.244,142,294565,0.482,0,74158,0,3,262968,0.011,3,337126,0.009,145,631691,0.23
2011,88,Other than New York State,Urban,Commercial,27,66623,0.405,24,9531,2.518,5,21112,0.237,29,30643,0.946,56,97266,0.576,0,36759,0,0,51640,0,0,88399,0,56,185665,0.302
2015,47,Suffolk,Urban,Other,9,13968,0.644,3,1177,2.549,1,547,1.828,4,1724,2.32,13,15692,0.828,0,9073,0,0,5333,0,0,14406,0,13,30098,0.432
2014,22,Jefferson,Urban,Medicare,3,8101,0.37,6,2648,2.266,0,1493,0,6,4141,1.449,9,12242,0.735,0,4209,0,0,9799,0,0,14008,0,9,26250,0.343
2014,4,Cattaraugus,Rural,Other,0,443,0,0,92,0,0,96,0,0,188,0,0,631,0,0,237,0,0,563,0,0,800,0,0,1431,0
2014,55,Westchester,Urban,Other,1,10022,0.1,3,948,3.165,0,595,0,3,1543,1.944,4,11565,0.346,0,2032,0,0,7981,0,0,10013,0,4,21578,0.185
2012,5,Cayuga,Rural,Medicare,3,4913,0.611,2,2435,0.821,0,1899,0,2,4334,0.461,5,9247,0.541,0,3466,0,0,6811,0,0,10277,0,5,19524,0.256
2014,19,Greene,Rural,Medicare,3,2748,1.092,4,2093,1.911,0,720,0,4,2813,1.422,7,5561,1.259,0,2523,0,0,4585,0,0,7108,0,7,12669,0.553
2014,15,Essex,Rural,Medicare,1,4244,0.236,1,801,1.248,0,603,0,1,1404,0.712,2,5648,0.354,0,1568,0,0,7083,0,0,8651,0,2,14299,0.14
2011,54,Wayne,Urban,Medicaid,5,7563,0.661,4,707,5.658,0,883,0,4,1590,2.516,9,9153,0.983,0,1356,0,0,4485,0,0,5841,0,9,14994,0.6
2015,14,Erie,Urban,Medicaid,510,135990,3.75,115,11561,9.947,10,13192,0.758,125,24753,5.05,635,160743,3.95,0,16140,0,0,68993,0,0,85133,0,635,245876,2.583
2015,31,Onondaga,Urban,Medicaid,200,64046,3.123,65,6969,9.327,5,6739,0.742,70,13708,5.107,270,77754,3.472,2,9099,0.22,3,45505,0.066,5,54604,0.092,275,132358,2.078
2014,35,Oswego,Urban,Commercial,15,11087,1.353,6,1580,3.797,4,2573,1.555,10,4153,2.408,25,15240,1.64,0,10023,0,0,8164,0,0,18187,0,25,33427,0.748
2012,39,Rockland,Urban,Medicaid,8,20984,0.381,11,3425,3.212,1,7361,0.136,12,10786,1.113,20,31770,0.63,0,3013,0,0,16268,0,0,19281,0,20,51051,0.392
2014,51,Ulster,Urban,Medicare,10,13583,0.736,9,6922,1.3,2,3126,0.64,11,10048,1.095,21,23631,0.889,0,6941,0,0,13272,0,0,20213,0,21,43844,0.479
2014,48,Sullivan,Rural,Commercial,26,18690,1.391,5,1396,3.582,1,1835,0.545,6,3231,1.857,32,21921,1.46,0,5033,0,0,7579,0,0,12612,0,32,34533,0.927
2014,4,Cattaraugus,Rural,Medicare,1,1917,0.522,3,943,3.181,1,773,1.294,4,1716,2.331,5,3633,1.376,0,1629,0,0,3465,0,0,5094,0,5,8727,0.573
2015,8,Chenango,Rural,Commercial,11,9523,1.155,1,503,1.988,1,1035,0.966,2,1538,1.3,13,11061,1.175,0,3711,0,1,8053,0.124,1,11764,0.085,14,22825,0.613
2011,,Statewide Total,State,All Payers,2924,6600787,0.443,3818,1505997,2.535,461,1083124,0.426,4279,2589121,1.653,7203,9189908,0.784,10,2171704,0.005,60,10702626,0.006,70,12874330,0.005,7273,22064238,0.33
2012,59,Kings (Brooklyn),Urban,Medicare,26,91109,0.285,107,84875,1.261,13,25287,0.514,120,110162,1.089,146,201271,0.725,0,49413,0,0,378152,0,0,427565,0,146,628836,0.232
2013,47,Suffolk,Urban,Medicaid,166,100662,1.649,129,17489,7.376,8,15559,0.514,137,33048,4.145,303,133710,2.266,0,14574,0,3,47400,0.063,3,61974,0.048,306,195684,1.564
2014,53,Washington,Urban,Medicaid,4,5568,0.718,5,727,6.878,0,789,0,5,1516,3.298,9,7084,1.27,0,1336,0,0,3025,0,0,4361,0,9,11445,0.786
2011,9,Clinton,Rural,Commercial,2,18173,0.11,10,1731,5.777,1,1754,0.57,11,3485,3.156,13,21658,0.6,2,10189,0.196,0,16464,0,2,26653,0.075,15,48311,0.31
2010,47,Suffolk,Urban,Other,2,11573,0.173,6,1693,3.544,0,619,0,6,2312,2.595,8,13885,0.576,0,3480,0,0,24,0,0,3504,0,8,17389,0.46
2012,55,Westchester,Urban,Medicare,13,39288,0.331,39,32955,1.183,6,12845,0.467,45,45800,0.983,58,85088,0.682,0,24742,0,0,96827,0,0,121569,0,58,206657,0.281
2013,7,Chemung,Urban,Commercial,13,21952,0.592,12,1655,7.251,0,2246,0,12,3901,3.076,25,25853,0.967,0,5527,0,0,41883,0,0,47410,0,25,73263,0.341
2011,38,Rensselaer,Urban,Other,1,1231,0.812,1,198,5.051,0,107,0,1,305,3.279,2,1536,1.302,0,217,0,0,1402,0,0,1619,0,2,3155,0.634
2012,13,Dutchess,Urban,Commercial,61,46320,1.317,20,5209,3.84,2,7960,0.251,22,13169,1.671,83,59489,1.395,0,15735,0,0,25054,0,0,40789,0,83,100278,0.828
2012,12,Delaware,Rural,Commercial,2,7984,0.251,2,467,4.283,1,912,1.096,3,1379,2.175,5,9363,0.534,0,2285,0,0,12289,0,0,14574,0,5,23937,0.209
2013,24,Livingston,Urban,Other,0,866,0,0,140,0,0,66,0,0,206,0,0,1072,0,0,307,0,0,499,0,0,806,0,0,1878,0
2015,8,Chenango,Rural,Medicaid,12,9899,1.212,2,359,5.571,2,779,2.567,4,1138,3.515,16,11037,1.45,0,1364,0,0,8944,0,0,10308,0,16,21345,0.75
2011,42,Schenectady,Urban,Medicaid,9,25321,0.355,1,642,1.558,8,3997,2.002,9,4639,1.94,18,29960,0.601,0,2375,0,0,12590,0,0,14965,0,18,44925,0.401
2014,7,Chemung,Urban,Commercial,9,15669,0.574,8,1284,6.231,0,1885,0,8,3169,2.524,17,18838,0.902,0,4878,0,0,68675,0,0,73553,0,17,92391,0.184
2011,49,Tioga,Urban,Other,0,294,0,0,24,0,0,16,0,0,40,0,0,334,0,0,47,0,0,138,0,0,185,0,0,519,0
2013,4,Cattaraugus,Rural,Medicare,3,1844,1.627,3,934,3.212,1,870,1.149,4,1804,2.217,7,3648,1.919,0,1723,0,0,3832,0,0,5555,0,7,9203,0.761
2014,28,Nassau,Urban,Other,2,9643,0.207,3,1312,2.287,0,471,0,3,1783,1.683,5,11426,0.438,0,3248,0,0,7786,0,0,11034,0,5,22460,0.223
2012,28,Nassau,Urban,Other,0,10243,0,4,1428,2.801,0,486,0,4,1914,2.09,4,12157,0.329,0,2646,0,0,5641,0,0,8287,0,4,20444,0.196
2014,49,Tioga,Urban,Commercial,3,3582,0.838,4,452,8.85,0,764,0,4,1216,3.289,7,4798,1.459,0,2234,0,0,9847,0,0,12081,0,7,16879,0.415
2015,27,Montgomery,Rural,Medicare,4,6399,0.625,7,2380,2.941,3,1080,2.778,10,3460,2.89,14,9859,1.42,0,3101,0,0,19152,0,0,22253,0,14,32112,0.436
2012,88,Other than New York State,Urban,Medicare,2,13658,0.146,15,7717,1.944,1,10452,0.096,16,18169,0.881,18,31827,0.566,0,13218,0,0,26808,0,0,40026,0,18,71853,0.251
2015,19,Greene,Rural,Commercial,6,4594,1.306,3,731,4.104,0,820,0,3,1551,1.934,9,6145,1.465,0,2960,0,0,5715,0,0,8675,0,9,14820,0.607
2013,39,Rockland,Urban,Medicare,5,12876,0.388,6,9506,0.631,1,4557,0.219,7,14063,0.498,12,26939,0.445,0,4369,0,1,29944,0.033,1,34313,0.029,13,61252,0.212
2015,30,Oneida,Urban,Other,0,2395,0,2,255,7.843,0,299,0,2,554,3.61,2,2949,0.678,0,797,0,0,2819,0,0,3616,0,2,6565,0.305
2010,,Statewide Total,State,Other,42,185766,0.226,79,28359,2.786,6,19466,0.308,85,47825,1.777,127,233591,0.544,1,47457,0.021,0,1988,0,1,49445,0.02,128,283036,0.452
2015,42,Schenectady,Urban,Medicaid,57,26187,2.177,3,899,3.337,22,3994,5.508,25,4893,5.109,82,31080,2.638,0,3208,0,0,17139,0,0,20347,0,82,51427,1.594
2014,40,St. Lawrence,Rural,Medicare,3,10125,0.296,9,3583,2.512,1,1332,0.751,10,4915,2.035,13,15040,0.864,0,5197,0,0,16888,0,0,22085,0,13,37125,0.35
2010,,Statewide Total,State,Medicare,302,728111,0.415,877,631639,1.388,100,265104,0.377,977,896743,1.089,1279,1624854,0.787,2,550486,0.004,0,8955,0,2,559441,0.004,1281,2184295,0.586
2014,1,Albany,Urban,Medicare,6,17544,0.342,16,9030,1.772,1,3171,0.315,17,12201,1.393,23,29745,0.773,0,12805,0,0,36142,0,0,48947,0,23,78692,0.292
2012,59,Kings (Brooklyn),Urban,Other,6,17900,0.335,4,2794,1.432,0,1033,0,4,3827,1.045,10,21727,0.46,0,3551,0,0,26358,0,0,29909,0,10,51636,0.194
2012,29,Niagara,Urban,Commercial,19,36921,0.515,36,5920,6.081,2,5986,0.334,38,11906,3.192,57,48827,1.167,0,20797,0,0,58173,0,0,78970,0,57,127797,0.446
2011,30,Oneida,Urban,Medicare,4,15527,0.258,13,10786,1.205,3,4571,0.656,16,15357,1.042,20,30884,0.648,0,13615,0,0,21682,0,0,35297,0,20,66181,0.302
2014,41,Saratoga,Urban,Commercial,25,17761,1.408,12,2611,4.596,4,5515,0.725,16,8126,1.969,41,25887,1.584,0,19355,0,1,28551,0.035,1,47906,0.021,42,73793,0.569
2011,34,Orleans,Urban,Commercial,7,8104,0.864,2,985,2.03,1,1174,0.852,3,2159,1.39,10,10263,0.974,0,3625,0,0,5358,0,0,8983,0,10,19246,0.52
2015,53,Washington,Urban,Medicare,3,4064,0.738,8,2348,3.407,3,717,4.184,11,3065,3.589,14,7129,1.964,0,3130,0,0,8170,0,0,11300,0,14,18429,0.76
2012,31,Onondaga,Urban,Medicare,22,24520,0.897,29,17039,1.702,4,5523,0.724,33,22562,1.463,55,47082,1.168,0,17167,0,0,30575,0,0,47742,0,55,94824,0.58
2014,6,Chautauqua,Rural,Medicare,15,11250,1.333,6,3768,1.592,0,1255,0,6,5023,1.195,21,16273,1.29,0,4830,0,0,20245,0,0,25075,0,21,41348,0.508
2011,88,Other than New York State,Urban,Medicare,1,11946,0.084,14,7373,1.899,1,10111,0.099,15,17484,0.858,16,29430,0.544,0,13236,0,0,26817,0,0,40053,0,16,69483,0.23
2012,58,Bronx,Urban,Commercial,49,292562,0.167,57,27402,2.08,7,19820,0.353,64,47222,1.355,113,339784,0.333,0,51706,0,0,324775,0,0,376481,0,113,716265,0.158
2015,4,Cattaraugus,Rural,Medicaid,7,2980,2.349,3,452,6.637,1,660,1.515,4,1112,3.597,11,4092,2.688,0,920,0,0,4043,0,0,4963,0,11,9055,1.215
2012,35,Oswego,Urban,Medicaid,11,11255,0.977,9,1443,6.237,0,2129,0,9,3572,2.52,20,14827,1.349,0,2068,0,0,11999,0,0,14067,0,20,28894,0.692
2013,59,Kings (Brooklyn),Urban,Medicare,36,93980,0.383,83,79678,1.042,12,23025,0.521,95,102703,0.925,131,196683,0.666,0,51875,0,0,365156,0,0,417031,0,131,613714,0.213
2013,37,Putnam,Urban,Medicaid,4,2885,1.386,1,379,2.639,0,524,0,1,903,1.107,5,3788,1.32,0,365,0,0,2611,0,0,2976,0,5,6764,0.739
2011,41,Saratoga,Urban,Medicaid,13,9458,1.374,11,1435,7.666,1,1646,0.608,12,3081,3.895,25,12539,1.994,0,2209,0,0,4223,0,0,6432,0,25,18971,1.318
2014,50,Tompkins,Urban,Commercial,8,11522,0.694,10,1140,8.772,0,1904,0,10,3044,3.285,18,14566,1.236,0,5324,0,0,18496,0,0,23820,0,18,38386,0.469
2015,10,Columbia,Rural,Medicaid,11,7064,1.557,10,778,12.853,1,765,1.307,11,1543,7.129,22,8607,2.556,0,1099,0,0,3378,0,0,4477,0,22,13084,1.681
2013,50,Tompkins,Urban,Commercial,7,12716,0.55,10,1234,8.104,1,1933,0.517,11,3167,3.473,18,15883,1.133,0,5548,0,0,21195,0,0,26743,0,18,42626,0.422
2015,41,Saratoga,Urban,Medicaid,28,9287,3.015,8,1328,6.024,2,1645,1.216,10,2973,3.364,38,12260,3.1,0,3237,0,0,8051,0,0,11288,0,38,23548,1.614
2013,58,Bronx,Urban,Other,1,13958,0.072,3,1746,1.718,0,742,0,3,2488,1.206,4,16446,0.243,0,3432,0,0,36670,0,0,40102,0,4,56548,0.071
2015,16,Franklin,Rural,Medicaid,0,2594,0,0,222,0,0,301,0,0,523,0,0,3117,0,0,391,0,0,2521,0,0,2912,0,0,6029,0
2014,25,Madison,Urban,Medicaid,16,8871,1.804,6,497,12.072,2,764,2.618,8,1261,6.344,24,10132,2.369,0,1374,0,0,2623,0,0,3997,0,24,14129,1.699
2014,7,Chemung,Urban,Medicare,4,7950,0.503,3,4102,0.731,1,1815,0.551,4,5917,0.676,8,13867,0.577,0,3954,0,1,84743,0.012,1,88697,0.011,9,102564,0.088
2014,50,Tompkins,Urban,Medicare,5,4966,1.007,3,1963,1.528,0,705,0,3,2668,1.124,8,7634,1.048,0,2870,0,0,9652,0,0,12522,0,8,20156,0.397
2015,32,Ontario,Urban,Commercial,16,15629,1.024,10,2012,4.97,3,2254,1.331,13,4266,3.047,29,19895,1.458,0,10744,0,1,14409,0.069,1,25153,0.04,30,45048,0.666
2011,28,Nassau,Urban,Medicaid,33,61549,0.536,66,15314,4.31,9,10272,0.876,75,25586,2.931,108,87135,1.239,0,8097,0,0,100085,0,0,108182,0,108,195317,0.553
2014,31,Onondaga,Urban,Other,4,3820,1.047,1,342,2.924,0,404,0,1,746,1.34,5,4566,1.095,0,1553,0,1,2591,0.386,1,4144,0.241,6,8710,0.689
2015,47,Suffolk,Urban,Commercial,430,210446,2.043,184,31179,5.901,49,33945,1.444,233,65124,3.578,663,275570,2.406,0,103684,0,0,126414,0,0,230098,0,663,505668,1.311
2015,43,Schoharie,Urban,Other,1,271,3.69,0,21,0,1,39,25.641,1,60,16.667,2,331,6.042,0,41,0,0,322,0,0,363,0,2,694,2.882
2015,3,Broome,Urban,Medicaid,85,23817,3.569,19,2184,8.7,2,2469,0.81,21,4653,4.513,106,28470,3.723,0,4298,0,3,49623,0.06,3,53921,0.056,109,82391,1.323
2012,36,Otsego,Rural,Commercial,11,9954,1.105,3,869,3.452,2,1201,1.665,5,2070,2.415,16,12024,1.331,0,3898,0,0,17626,0,0,21524,0,16,33548,0.477
2014,58,Bronx,Urban,Medicaid,113,454900,0.248,307,74252,4.135,19,41178,0.461,326,115430,2.824,439,570330,0.77,0,45700,0,5,969903,0.005,5,1015603,0.005,444,1585933,0.28
2015,88,Other than New York State,Urban,Commercial,100,78010,1.282,49,10115,4.844,27,20286,1.331,76,30401,2.5,176,108411,1.623,0,42937,0,4,77831,0.051,4,120768,0.033,180,229179,0.785
2015,30,Oneida,Urban,Commercial,20,20273,0.987,9,1961,4.589,5,3968,1.26,14,5929,2.361,34,26202,1.298,0,16147,0,1,20729,0.048,1,36876,0.027,35,63078,0.555
2015,17,Fulton,Rural,Medicaid,13,13367,0.973,5,834,5.995,0,1026,0,5,1860,2.688,18,15227,1.182,0,1887,0,0,6558,0,0,8445,0,18,23672,0.76
2011,12,Delaware,Rural,Medicaid,4,6288,0.636,1,346,2.89,1,550,1.818,2,896,2.232,6,7184,0.835,0,833,0,0,23233,0,0,24066,0,6,31250,0.192
2010,47,Suffolk,Urban,Medicare,32,48167,0.664,93,55650,1.671,4,17138,0.233,97,72788,1.333,129,120955,1.067,0,32595,0,0,137,0,0,32732,0,129,153687,0.839
2014,33,Orange,Urban,Medicaid,37,32989,1.122,25,4046,6.179,3,5705,0.526,28,9751,2.872,65,42740,1.521,0,5019,0,0,8876,0,0,13895,0,65,56635,1.148
2013,7,Chemung,Urban,Medicare,4,7295,0.548,9,4258,2.114,1,1513,0.661,10,5771,1.733,14,13066,1.071,0,4009,0,0,46714,0,0,50723,0,14,63789,0.219
2015,2,Allegany,Rural,Medicare,6,3901,1.538,3,1097,2.735,1,515,1.942,4,1612,2.481,10,5513,1.814,0,1736,0,0,11818,0,0,13554,0,10,19067,0.524
2011,39,Rockland,Urban,Medicaid,7,17877,0.392,12,3791,3.165,0,6755,0,12,10546,1.138,19,28423,0.668,0,2785,0,0,11526,0,0,14311,0,19,42734,0.445
2015,7,Chemung,Urban,Medicare,3,9261,0.324,5,3805,1.314,1,1520,0.658,6,5325,1.127,9,14586,0.617,0,3734,0,0,82263,0,0,85997,0,9,100583,0.089
2013,18,Genesee,Rural,Commercial,6,8103,0.74,5,914,5.47,0,1505,0,5,2419,2.067,11,10522,1.045,0,4784,0,0,17425,0,0,22209,0,11,32731,0.336
2015,21,Herkimer,Urban,Medicare,3,5280,0.568,4,1949,2.052,0,1595,0,4,3544,1.129,7,8824,0.793,1,2701,0.37,0,25007,0,1,27708,0.036,8,36532,0.219
2015,29,Niagara,Urban,Medicare,17,14496,1.173,34,7424,4.58,6,2946,2.037,40,10370,3.857,57,24866,2.292,0,11244,0,0,30365,0,0,41609,0,57,66475,0.857
2011,13,Dutchess,Urban,Medicaid,25,18083,1.383,16,1908,8.386,1,2581,0.387,17,4489,3.787,42,22572,1.861,0,1511,0,0,7469,0,0,8980,0,42,31552,1.331
2012,15,Essex,Rural,Medicaid,2,4076,0.491,2,228,8.772,0,202,0,2,430,4.651,4,4506,0.888,0,363,0,0,2361,0,0,2724,0,4,7230,0.553
2012,32,Ontario,Urban,Medicare,3,6953,0.431,3,3466,0.866,0,1315,0,3,4781,0.627,6,11734,0.511,0,4884,0,0,11226,0,0,16110,0,6,27844,0.215
2014,51,Ulster,Urban,Medicaid,27,21536,1.254,11,1500,7.333,3,2560,1.172,14,4060,3.448,41,25596,1.602,0,2106,0,0,4973,0,0,7079,0,41,32675,1.255
2015,12,Delaware,Rural,Commercial,2,7686,0.26,4,359,11.142,0,832,0,4,1191,3.359,6,8877,0.676,0,2473,0,0,17722,0,0,20195,0,6,29072,0.206
2015,42,Schenectady,Urban,Other,1,930,1.075,0,75,0,0,307,0,0,382,0,1,1312,0.762,0,272,0,0,1872,0,0,2144,0,1,3456,0.289
2013,35,Oswego,Urban,Medicare,6,5790,1.036,9,4727,1.904,1,1664,0.601,10,6391,1.565,16,12181,1.314,0,6352,0,0,12306,0,0,18658,0,16,30839,0.519
2014,45,Seneca,Rural,Other,0,602,0,0,83,0,0,62,0,0,145,0,0,747,0,0,308,0,0,420,0,0,728,0,0,1475,0
2015,41,Saratoga,Urban,Other,1,1494,0.669,1,160,6.25,0,346,0,1,506,1.976,2,2000,1,0,640,0,0,1884,0,0,2524,0,2,4524,0.442
2013,22,Jefferson,Urban,Medicaid,7,9566,0.732,1,639,1.565,1,885,1.13,2,1524,1.312,9,11090,0.812,0,1216,0,0,3409,0,0,4625,0,9,15715,0.573
2013,50,Tompkins,Urban,Medicare,3,4966,0.604,6,1902,3.155,1,734,1.362,7,2636,2.656,10,7602,1.315,0,2741,0,1,10727,0.093,1,13468,0.074,11,21070,0.522
2012,18,Genesee,Rural,Commercial,4,9810,0.408,4,1074,3.724,0,1737,0,4,2811,1.423,8,12621,0.634,0,4661,0,0,17757,0,0,22418,0,8,35039,0.228
2015,38,Rensselaer,Urban,Medicaid,27,21500,1.256,6,1978,3.033,3,1909,1.572,9,3887,2.315,36,25387,1.418,0,2788,0,0,14941,0,0,17729,0,36,43116,0.835
2014,40,St. Lawrence,Rural,Commercial,11,23940,0.459,6,1711,3.507,0,2322,0,6,4033,1.488,17,27973,0.608,0,8422,0,0,18633,0,0,27055,0,17,55028,0.309
2013,21,Herkimer,Urban,Medicaid,1,6359,0.157,5,565,8.85,4,1006,3.976,9,1571,5.729,10,7930,1.261,0,1174,0,0,25703,0,0,26877,0,10,34807,0.287
2012,35,Oswego,Urban,Commercial,20,13472,1.485,9,2081,4.325,1,2814,0.355,10,4895,2.043,30,18367,1.633,0,9282,0,0,9745,0,0,19027,0,30,37394,0.802
2011,99,Unknown,Urban,Other,5,6737,0.742,0,476,0,0,255,0,0,731,0,5,7468,0.67,0,3279,0,0,4616,0,0,7895,0,5,15363,0.325
2014,42,Schenectady,Urban,Commercial,28,24360,1.149,3,908,3.304,5,4606,1.086,8,5514,1.451,36,29874,1.205,0,12994,0,0,25087,0,0,38081,0,36,67955,0.53
2011,14,Erie,Urban,Commercial,129,114040,1.131,61,13748,4.437,2,22857,0.088,63,36605,1.721,192,150645,1.275,0,77942,0,1,128290,0.008,1,206232,0.005,193,356877,0.541
2015,23,Lewis,Rural,Other,0,943,0,0,29,0,0,74,0,0,103,0,0,1046,0,0,148,0,0,233,0,0,381,0,0,1427,0
2012,28,Nassau,Urban,Medicare,18,52547,0.343,57,54889,1.038,5,18094,0.276,62,72983,0.85,80,125530,0.637,0,40994,0,0,92675,0,0,133669,0,80,259199,0.309
2012,41,Saratoga,Urban,Commercial,19,23826,0.797,13,3037,4.281,2,5314,0.376,15,8351,1.796,34,32177,1.057,0,19278,0,0,16412,0,0,35690,0,34,67867,0.501
2015,45,Seneca,Rural,Medicaid,3,3355,0.894,3,222,13.514,0,308,0,3,530,5.66,6,3885,1.544,0,587,0,0,1848,0,0,2435,0,6,6320,0.949
2014,21,Herkimer,Urban,Medicaid,14,7070,1.98,6,560,10.714,7,985,7.107,13,1545,8.414,27,8615,3.134,0,1197,0,0,20799,0,0,21996,0,27,30611,0.882
2012,12,Delaware,Rural,Other,0,564,0,0,65,0,0,56,0,0,121,0,0,685,0,0,62,0,0,476,0,0,538,0,0,1223,0
2014,23,Lewis,Rural,Medicaid,1,2164,0.462,0,134,0,1,305,3.279,1,439,2.278,2,2603,0.768,0,374,0,0,807,0,0,1181,0,2,3784,0.529
2014,17,Fulton,Rural,Commercial,4,11560,0.346,2,716,2.793,0,1013,0,2,1729,1.157,6,13289,0.452,0,4252,0,0,10154,0,0,14406,0,6,27695,0.217
2011,41,Saratoga,Urban,Commercial,16,23789,0.673,9,3399,2.648,5,5564,0.899,14,8963,1.562,30,32752,0.916,0,18585,0,1,21257,0.047,1,39842,0.025,31,72594,0.427
2011,99,Unknown,Urban,Commercial,38,94174,0.404,16,7547,2.12,2,9294,0.215,18,16841,1.069,56,111015,0.504,2,70487,0.028,1,82443,0.012,3,152930,0.02,59,263945,0.224
2011,31,Onondaga,Urban,Medicare,18,21201,0.849,31,16965,1.827,2,5594,0.358,33,22559,1.463,51,43760,1.165,0,13372,0,0,32412,0,0,45784,0,51,89544,0.57
2015,27,Montgomery,Rural,Other,1,702,1.425,0,35,0,0,52,0,0,87,0,1,789,1.267,0,86,0,0,622,0,0,708,0,1,1497,0.668
2012,8,Chenango,Rural,Medicare,2,5143,0.389,3,1823,1.646,3,1127,2.662,6,2950,2.034,8,8093,0.989,0,1826,0,0,34269,0,0,36095,0,8,44188,0.181
2015,88,Other than New York State,Urban,Other,0,6248,0,3,609,4.926,0,652,0,3,1261,2.379,3,7509,0.4,0,1265,0,0,4726,0,0,5991,0,3,13500,0.222
2013,4,Cattaraugus,Rural,Commercial,6,4555,1.317,0,475,0,0,1129,0,0,1604,0,6,6159,0.974,0,3061,0,1,8222,0.122,1,11283,0.089,7,17442,0.401
2012,5,Cayuga,Rural,Commercial,8,11874,0.674,6,1079,5.561,4,2216,1.805,10,3295,3.035,18,15169,1.187,0,5848,0,1,14914,0.067,1,20762,0.048,19,35931,0.529
2011,38,Rensselaer,Urban,Medicare,3,7406,0.405,9,6242,1.442,0,1776,0,9,8018,1.122,12,15424,0.778,0,4875,0,0,8912,0,0,13787,0,12,29211,0.411
2012,60,New York (Manhattan),Urban,Medicare,13,62900,0.207,98,49805,1.968,14,21727,0.644,112,71532,1.566,125,134432,0.93,0,42207,0,1,346534,0.003,1,388741,0.003,126,523173,0.241
2013,2,Allegany,Rural,Medicare,2,3616,0.553,1,1006,0.994,0,559,0,1,1565,0.639,3,5181,0.579,0,1716,0,0,5738,0,0,7454,0,3,12635,0.237
2010,38,Rensselaer,Urban,Commercial,15,19282,0.778,6,2895,2.073,1,3573,0.28,7,6468,1.082,22,25750,0.854,0,11231,0,0,25,0,0,11256,0,22,37006,0.594
2015,12,Delaware,Rural,Medicare,2,6261,0.319,4,979,4.086,3,1446,2.075,7,2425,2.887,9,8686,1.036,0,2303,0,0,32541,0,0,34844,0,9,43530,0.207
2011,14,Erie,Urban,Other,4,12085,0.331,5,1194,4.188,1,927,1.079,6,2121,2.829,10,14206,0.704,0,2212,0,0,5695,0,0,7907,0,10,22113,0.452
2015,40,St. Lawrence,Rural,Medicaid,4,15560,0.257,7,1141,6.135,2,1499,1.334,9,2640,3.409,13,18200,0.714,0,2398,0,0,6039,0,0,8437,0,13,26637,0.488
2015,88,Other than New York State,Urban,Medicare,6,18259,0.329,36,9129,3.943,17,9736,1.746,53,18865,2.809,59,37124,1.589,1,17264,0.058,2,46109,0.043,3,63373,0.047,62,100497,0.617
2015,9,Clinton,Rural,Medicare,3,6885,0.436,2,2903,0.689,0,672,0,2,3575,0.559,5,10460,0.478,0,3440,0,0,15915,0,0,19355,0,5,29815,0.168
2013,23,Lewis,Rural,Medicaid,0,331,0,0,89,0,2,160,12.5,2,249,8.032,2,580,3.448,0,237,0,0,427,0,0,664,0,2,1244,1.608
2013,40,St. Lawrence,Rural,Medicare,6,10386,0.578,12,3666,3.273,2,1651,1.211,14,5317,2.633,20,15703,1.274,0,5184,0,0,16249,0,0,21433,0,20,37136,0.539
2015,61,Queens,Urban,Medicaid,95,309727,0.307,119,53204,2.237,23,39652,0.58,142,92856,1.529,237,402583,0.589,0,46774,0,10,654643,0.015,10,701417,0.014,247,1104000,0.224
2015,29,Niagara,Urban,Commercial,59,32138,1.836,20,4424,4.521,5,5824,0.859,25,10248,2.44,84,42386,1.982,0,20617,0,0,66131,0,0,86748,0,84,129134,0.65
2014,7,Chemung,Urban,Medicaid,6,16001,0.375,4,1256,3.185,0,1432,0,4,2688,1.488,10,18689,0.535,0,1600,0,0,27757,0,0,29357,0,10,48046,0.208
2013,18,Genesee,Rural,Medicaid,8,5081,1.574,6,494,12.146,0,652,0,6,1146,5.236,14,6227,2.248,0,787,0,0,6959,0,0,7746,0,14,13973,1.002
2012,47,Suffolk,Urban,Medicaid,94,82444,1.14,82,16183,5.067,4,12812,0.312,86,28995,2.966,180,111439,1.615,0,10225,0,1,38808,0.026,1,49033,0.02,181,160472,1.128
2014,37,Putnam,Urban,Medicare,0,4730,0,4,2636,1.517,0,1008,0,4,3644,1.098,4,8374,0.478,0,3087,0,0,5335,0,0,8422,0,4,16796,0.238
2015,2,Allegany,Rural,Commercial,5,8577,0.583,2,359,5.571,1,774,1.292,3,1133,2.648,8,9710,0.824,0,2228,0,0,13922,0,0,16150,0,8,25860,0.309
2014,40,St. Lawrence,Rural,Other,8,6838,1.17,3,580,5.172,0,386,0,3,966,3.106,11,7804,1.41,0,1029,0,0,3031,0,0,4060,0,11,11864,0.927
2012,99,Unknown,Urban,Medicare,16,31790,0.503,30,11423,2.626,3,8054,0.372,33,19477,1.694,49,51267,0.956,0,30612,0,0,63935,0,0,94547,0,49,145814,0.336
2014,60,New York (Manhattan),Urban,Medicare,20,73538,0.272,106,48328,2.193,12,17044,0.704,118,65372,1.805,138,138910,0.993,0,50379,0,1,388196,0.003,1,438575,0.002,139,577485,0.241
2010,60,New York (Manhattan),Urban,Medicaid,87,210238,0.414,139,37811,3.676,22,26502,0.83,161,64313,2.503,248,274551,0.903,0,33481,0,0,101,0,0,33582,0,248,308133,0.805
2014,14,Erie,Urban,Commercial,181,106197,1.704,54,11311,4.774,6,20704,0.29,60,32015,1.874,241,138212,1.744,1,81948,0.012,0,141397,0,1,223345,0.004,242,361557,0.669
2014,28,Nassau,Urban,Commercial,158,152104,1.039,91,24542,3.708,12,35692,0.336,103,60234,1.71,261,212338,1.229,0,70790,0,0,163292,0,0,234082,0,261,446420,0.585
2015,28,Nassau,Urban,Medicaid,111,105119,1.056,107,17316,6.179,12,13665,0.878,119,30981,3.841,230,136100,1.69,0,14449,0,0,126775,0,0,141224,0,230,277324,0.829
2015,20,Hamilton,Rural,Medicaid,0,226,0,0,39,0,0,36,0,0,75,0,0,301,0,0,78,0,0,167,0,0,245,0,0,546,0
2015,3,Broome,Urban,Medicare,15,12925,1.161,12,6184,1.94,2,2212,0.904,14,8396,1.667,29,21321,1.36,0,8489,0,1,30419,0.033,1,38908,0.026,30,60229,0.498
2010,88,Other than New York State,Urban,Commercial,17,56723,0.3,26,8954,2.904,2,18849,0.106,28,27803,1.007,45,84526,0.532,0,35184,0,0,94,0,0,35278,0,45,119804,0.376
2013,60,New York (Manhattan),Urban,Other,1,9695,0.103,5,1257,3.978,0,636,0,5,1893,2.641,6,11588,0.518,0,5692,0,0,10752,0,0,16444,0,6,28032,0.214
2012,13,Dutchess,Urban,Medicaid,32,17806,1.797,16,1784,8.969,3,2523,1.189,19,4307,4.411,51,22113,2.306,0,1688,0,0,6630,0,0,8318,0,51,30431,1.676
2012,1,Albany,Urban,Medicare,7,18511,0.378,11,10896,1.01,3,3291,0.912,14,14187,0.987,21,32698,0.642,0,12378,0,0,21242,0,0,33620,0,21,66318,0.317
2011,29,Niagara,Urban,Other,0,2469,0,1,245,4.082,0,232,0,1,477,2.096,1,2946,0.339,0,474,0,0,1053,0,0,1527,0,1,4473,0.224
2010,28,Nassau,Urban,Medicare,13,39065,0.333,61,51865,1.176,7,16928,0.414,68,68793,0.988,81,107858,0.751,0,30513,0,0,1559,0,0,32072,0,81,139930,0.579
2012,42,Schenectady,Urban,Medicaid,15,26340,0.569,2,645,3.101,13,3841,3.385,15,4486,3.344,30,30826,0.973,0,2457,0,0,11305,0,0,13762,0,30,44588,0.673
2015,2,Allegany,Rural,Medicaid,19,6185,3.072,0,222,0,0,457,0,0,679,0,19,6864,2.768,0,778,0,0,5818,0,0,6596,0,19,13460,1.412
2015,59,Kings (Brooklyn),Urban,Unknown,3,6352,0.472,0,47,0,11,1432,7.682,11,1479,7.437,14,7831,1.788,0,620,0,0,1982,0,0,2602,0,14,10433,1.342
2012,38,Rensselaer,Urban,Unknown,0,0,0,0,0,0,0,1,0,0,1,0,0,1,0,0,3,0,0,0,0,0,3,0,0,4,0
2010,41,Saratoga,Urban,Unknown,9,9150,0.984,0,29,0,0,12,0,0,41,0,9,9191,0.979,0,6405,0,0,0,0,0,6405,0,9,15596,0.577
2015,36,Otsego,Rural,Unknown,1,56,17.857,0,17,0,0,6,0,0,23,0,1,79,12.658,0,13,0,0,53,0,0,66,0,1,145,6.897
2014,5,Cayuga,Rural,Unknown,0,8,0,0,1,0,0,1,0,0,2,0,0,10,0,0,98,0,0,9,0,0,107,0,0,117,0
2013,44,Schuyler,Rural,Unknown,0,1,0,0,1,0,0,2,0,0,3,0,0,4,0,0,4,0,0,29,0,0,33,0,0,37,0
2012,59,Kings (Brooklyn),Urban,Unknown,3,7947,0.378,5,391,12.788,2,441,4.535,7,832,8.413,10,8779,1.139,0,995,0,0,2169,0,0,3164,0,10,11943,0.837
2012,48,Sullivan,Rural,Unknown,0,12,0,0,0,0,0,0,0,0,0,0,0,12,0,0,45,0,0,288,0,0,333,0,0,345,0
2010,99,Unknown,Urban,Unknown,2,8050,0.248,2,521,3.839,0,718,0,2,1239,1.614,4,9289,0.431,0,19062,0,0,0,0,0,19062,0,4,28351,0.141
2012,25,Madison,Urban,Unknown,0,0,,0,0,,0,0,,0,0,,0,0,,0,462,0,0,51,0,0,513,0,0,513,0
2011,26,Monroe,Urban,Unknown,0,190,0,0,0,0,0,0,0,0,0,0,0,190,0,0,15066,0,0,0,0,0,15066,0,0,15256,0
2011,33,Orange,Urban,Unknown,8,10808,0.74,1,366,2.732,0,354,0,1,720,1.389,9,11528,0.781,0,1335,0,0,1394,0,0,2729,0,9,14257,0.631
2015,50,Tompkins,Urban,Unknown,0,4,0,0,0,0,0,4,0,0,4,0,0,8,0,0,8,0,0,10,0,0,18,0,0,26,0
2011,27,Montgomery,Rural,Unknown,0,2,0,0,0,0,0,0,0,0,0,0,0,2,0,0,0,0,0,35,0,0,35,0,0,37,0
2014,56,Wyoming,Rural,Unknown,0,1,0,0,0,0,0,0,0,0,0,0,0,1,0,0,7,0,0,2,0,0,9,0,0,10,0
2010,56,Wyoming,Rural,Unknown,0,292,0,0,16,0,0,8,0,0,24,0,0,316,0,0,312,0,0,0,0,0,312,0,0,628,0
2011,30,Oneida,Urban,Unknown,0,3,0,0,1,0,0,0,0,0,1,0,0,4,0,0,3,0,0,7,0,0,10,0,0,14,0
2015,31,Onondaga,Urban,Unknown,0,51,0,1,29,34.483,0,1,0,1,30,33.333,1,81,12.346,0,70,0,0,7,0,0,77,0,1,158,6.329
2015,4,Cattaraugus,Rural,Unknown,0,0,,0,0,,0,0,,0,0,,0,0,,0,3,0,0,2,0,0,5,0,0,5,0
2011,40,St. Lawrence,Rural,Unknown,0,2,0,0,0,0,0,0,0,0,0,0,0,2,0,0,6,0,0,0,0,0,6,0,0,8,0
2015,37,Putnam,Urban,Unknown,0,3,0,0,0,0,0,0,0,0,0,0,0,3,0,0,10,0,0,4,0,0,14,0,0,17,0
2014,55,Westchester,Urban,Unknown,0,87,0,0,10,0,0,46,0,0,56,0,0,143,0,0,158,0,0,544,0,0,702,0,0,845,0
2010,37,Putnam,Urban,Unknown,1,3141,0.318,3,312,9.615,0,309,0,3,621,4.831,4,3762,1.063,0,787,0,0,0,0,0,787,0,4,4549,0.879
2010,29,Niagara,Urban,Unknown,0,2686,0,2,451,4.435,0,25,0,2,476,4.202,2,3162,0.633,0,4107,0,0,0,0,0,4107,0,2,7269,0.275
2011,21,Herkimer,Urban,Unknown,0,1,0,0,0,0,0,0,0,0,0,0,0,1,0,0,1,0,0,41,0,0,42,0,0,43,0
2014,51,Ulster,Urban,Unknown,0,12,0,0,1,0,0,1,0,0,2,0,0,14,0,0,6,0,0,0,0,0,6,0,0,20,0
2012,20,Hamilton,Rural,Unknown,0,0,,0,0,,0,0,,0,0,,0,0,,0,3,0,0,1,0,0,4,0,0,4,0
2015,43,Schoharie,Urban,Unknown,0,1,0,0,1,0,0,2,0,0,3,0,0,4,0,0,0,0,0,1,0,0,1,0,0,5,0
2014,14,Erie,Urban,Unknown,0,14,0,0,1,0,0,2,0,0,3,0,0,17,0,0,803,0,0,107,0,0,910,0,0,927,0
2011,46,Steuben,Rural,Unknown,0,1,0,0,0,0,0,0,0,0,0,0,0,1,0,0,109,0,0,0,0,0,109,0,0,110,0
2010,2,Allegany,Rural,Unknown,2,2765,0.723,0,25,0,0,19,0,0,44,0,2,2809,0.712,0,875,0,0,0,0,0,875,0,2,3684,0.543
2010,1,Albany,Urban,Unknown,8,8663,0.923,0,72,0,0,31,0,0,103,0,8,8766,0.913,0,2571,0,0,0,0,0,2571,0,8,11337,0.706
2011,59,Kings (Brooklyn),Urban,Unknown,4,6257,0.639,5,403,12.407,0,156,0,5,559,8.945,9,6816,1.32,0,2500,0,0,2096,0,0,4596,0,9,11412,0.789
2013,31,Onondaga,Urban,Unknown,0,2,0,0,0,0,0,0,0,0,0,0,0,2,0,0,5469,0,0,538,0,0,6007,0,0,6009,0
2013,7,Chemung,Urban,Unknown,0,87,0,0,4,0,0,8,0,0,12,0,0,99,0,0,38,0,0,426,0,0,464,0,0,563,0
2010,47,Suffolk,Urban,Unknown,29,41898,0.692,6,1718,3.492,0,1054,0,6,2772,2.165,35,44670,0.784,0,28505,0,0,0,0,0,28505,0,35,73175,0.478
2014,30,Oneida,Urban,Unknown,5,4962,1.008,0,292,0,1,1029,0.972,1,1321,0.757,6,6283,0.955,0,1780,0,0,1632,0,0,3412,0,6,9695,0.619
2012,49,Tioga,Urban,Unknown,0,0,,0,0,,0,0,,0,0,,0,0,,0,6,0,0,0,0,0,6,0,0,6,0
2010,39,Rockland,Urban,Unknown,11,17273,0.637,0,117,0,0,792,0,0,909,0,11,18182,0.605,0,4046,0,0,0,0,0,4046,0,11,22228,0.495
2010,30,Oneida,Urban,Unknown,3,8138,0.369,4,796,5.025,0,542,0,4,1338,2.99,7,9476,0.739,0,3986,0,0,0,0,0,3986,0,7,13462,0.52
2011,49,Tioga,Urban,Unknown,0,127,0,0,15,0,0,1,0,0,16,0,0,143,0,0,4,0,0,1,0,0,5,0,0,148,0
2010,60,New York (Manhattan),Urban,Unknown,13,35649,0.365,7,7614,0.919,2,6711,0.298,9,14325,0.628,22,49974,0.44,0,28412,0,0,0,0,0,28412,0,22,78386,0.281
2015,17,Fulton,Rural,Unknown,0,6,0,0,4,0,0,1,0,0,5,0,0,11,0,0,5,0,0,7,0,0,12,0,0,23,0
2013,23,Lewis,Rural,Unknown,0,0,,0,0,,0,0,,0,0,,0,0,,0,45,0,0,8,0,0,53,0,0,53,0
2010,62,Richmond (Staten Island),Urban,Unknown,2,3441,0.581,1,386,2.591,0,738,0,1,1124,0.89,3,4565,0.657,0,1985,0,0,0,0,0,1985,0,3,6550,0.458
2010,52,Warren,Urban,Unknown,4,5511,0.726,0,0,0,0,7,0,0,7,0,4,5518,0.725,0,3136,0,0,0,0,0,3136,0,4,8654,0.462
2013,36,Otsego,Rural,Unknown,0,5,0,0,0,0,0,2,0,0,2,0,0,7,0,0,7,0,0,14,0,0,21,0,0,28,0
2013,3,Broome,Urban,Unknown,0,11,0,0,0,0,0,1,0,0,1,0,0,12,0,0,49,0,0,12,0,0,61,0,0,73,0
2010,50,Tompkins,Urban,Unknown,3,7890,0.38,0,8,0,0,34,0,0,42,0,3,7932,0.378,0,2574,0,0,0,0,0,2574,0,3,10506,0.286
2011,55,Westchester,Urban,Unknown,0,251,0,0,5,0,0,44,0,0,49,0,0,300,0,0,2889,0,0,574,0,0,3463,0,0,3763,0
2013,52,Warren,Urban,Unknown,0,0,,0,0,,0,0,,0,0,,0,0,,0,2,0,0,0,0,0,2,0,0,2,0
2012,8,Chenango,Rural,Unknown,0,5,0,0,0,0,0,1,0,0,1,0,0,6,0,0,34,0,0,10,0,0,44,0,0,50,0
2010,44,Schuyler,Rural,Unknown,0,499,0,0,1,0,0,5,0,0,6,0,0,505,0,0,327,0,0,0,0,0,327,0,0,832,0
2011,50,Tompkins,Urban,Unknown,0,5,0,0,0,0,0,0,0,0,0,0,0,5,0,0,4,0,0,0,0,0,4,0,0,9,0
2010,10,Columbia,Rural,Unknown,1,503,1.988,0,7,0,0,23,0,0,30,0,1,533,1.876,0,336,0,0,0,0,0,336,0,1,869,1.151
2012,31,Onondaga,Urban,Unknown,0,1,0,0,1,0,0,0,0,0,1,0,0,2,0,0,3962,0,0,358,0,0,4320,0,0,4322,0
2015,46,Steuben,Rural,Unknown,0,10,0,0,5,0,0,7,0,0,12,0,0,22,0,0,11,0,0,151,0,0,162,0,0,184,0
2010,22,Jefferson,Urban,Unknown,4,17162,0.233,1,293,3.413,0,511,0,1,804,1.244,5,17966,0.278,0,4508,0,0,1,0,0,4509,0,5,22475,0.222
2011,58,Bronx,Urban,Unknown,0,326,0,0,16,0,0,82,0,0,98,0,0,424,0,0,8305,0,0,150,0,0,8455,0,0,8879,0
2015,56,Wyoming,Rural,Unknown,0,0,0,0,0,0,0,1,0,0,1,0,0,1,0,0,1,0,0,0,0,0,1,0,0,2,0
2015,13,Dutchess,Urban,Unknown,0,7,0,0,2,0,0,1,0,0,3,0,0,10,0,0,46,0,0,6,0,0,52,0,0,62,0
2013,57,Yates,Urban,Unknown,0,0,,0,0,,0,0,,0,0,,0,0,,0,39,0,0,4,0,0,43,0,0,43,0
2013,30,Oneida,Urban,Unknown,0,0,,0,0,,0,0,,0,0,,0,0,,0,484,0,0,50,0,0,534,0,0,534,0
2013,16,Franklin,Rural,Unknown,0,0,0,0,6,0,0,1,0,0,7,0,0,7,0,0,8,0,0,18,0,0,26,0,0,33,0
2013,,Statewide Total,State,Unknown,1,13765,0.073,13,2211,5.88,8,2182,3.666,21,4393,4.78,22,18158,1.212,0,47691,0,0,8022,0,0,55713,0,22,73871,0.298
2015,14,Erie,Urban,Unknown,0,16,0,0,2,0,0,1,0,0,3,0,0,19,0,0,108,0,0,176,0,0,284,0,0,303,0
2013,6,Chautauqua,Rural,Unknown,0,2,0,0,0,0,0,0,0,0,0,0,0,2,0,0,19,0,0,1,0,0,20,0,0,22,0
2012,15,Essex,Rural,Unknown,0,0,,0,0,,0,0,,0,0,,0,0,,0,2,0,0,1,0,0,3,0,0,3,0
2014,28,Nassau,Urban,Unknown,1,116,8.621,0,194,0,0,182,0,0,376,0,1,492,2.033,0,1238,0,0,47,0,0,1285,0,1,1777,0.563
2013,61,Queens,Urban,Unknown,0,812,0,0,281,0,0,250,0,0,531,0,0,1343,0,0,1061,0,0,328,0,0,1389,0,0,2732,0
2011,8,Chenango,Rural,Unknown,0,89,0,0,2,0,0,6,0,0,8,0,0,97,0,0,3,0,0,51,0,0,54,0,0,151,0
2014,54,Wayne,Urban,Unknown,0,4,0,0,0,0,0,0,0,0,0,0,0,4,0,0,74,0,0,0,0,0,74,0,0,78,0
2014,9,Clinton,Rural,Unknown,1,748,1.337,1,256,3.906,0,53,0,1,309,3.236,2,1057,1.892,0,352,0,0,1159,0,0,1511,0,2,2568,0.779
2011,37,Putnam,Urban,Unknown,0,27,0,0,5,0,0,5,0,0,10,0,0,37,0,0,106,0,0,28,0,0,134,0,0,171,0
2012,29,Niagara,Urban,Unknown,0,1,0,0,0,0,0,0,0,0,0,0,0,1,0,0,1492,0,0,19,0,0,1511,0,0,1512,0
2014,47,Suffolk,Urban,Unknown,0,115,0,0,310,0,1,215,4.651,1,525,1.905,1,640,1.563,0,559,0,0,336,0,0,895,0,1,1535,0.651
2012,41,Saratoga,Urban,Unknown,0,0,,0,0,,0,0,,0,0,,0,0,,0,2,0,0,0,0,0,2,0,0,2,0
2011,7,Chemung,Urban,Unknown,0,5,0,0,1,0,0,0,0,0,1,0,0,6,0,0,38,0,0,0,0,0,38,0,0,44,0
2012,,Statewide Total,State,Unknown,5,14737,0.339,8,1563,5.118,2,1537,1.301,10,3100,3.226,15,17837,0.841,0,47296,0,0,6244,0,0,53540,0,15,71377,0.21
2012,60,New York (Manhattan),Urban,Unknown,0,745,0,0,111,0,0,191,0,0,302,0,0,1047,0,0,1025,0,0,459,0,0,1484,0,0,2531,0
2010,8,Chenango,Rural,Unknown,0,600,0,0,50,0,0,50,0,0,100,0,0,700,0,0,336,0,0,0,0,0,336,0,0,1036,0
2015,47,Suffolk,Urban,Unknown,0,91,0,0,63,0,2,56,35.714,2,119,16.807,2,210,9.524,0,424,0,0,291,0,0,715,0,2,925,2.162
2010,17,Fulton,Rural,Unknown,0,675,0,0,16,0,0,152,0,0,168,0,0,843,0,0,447,0,0,0,0,0,447,0,0,1290,0
2010,28,Nassau,Urban,Unknown,21,27549,0.762,14,7548,1.855,2,2823,0.708,16,10371,1.543,37,37920,0.976,0,19170,0,0,0,0,0,19170,0,37,57090,0.648
2012,6,Chautauqua,Rural,Unknown,0,16,0,0,0,0,0,0,0,0,0,0,0,16,0,0,26,0,0,5,0,0,31,0,0,47,0
2015,23,Lewis,Rural,Unknown,0,27,0,0,9,0,0,33,0,0,42,0,0,69,0,0,146,0,0,54,0,0,200,0,0,269,0
2014,15,Essex,Rural,Unknown,0,47,0,0,28,0,0,10,0,0,38,0,0,85,0,0,66,0,0,116,0,0,182,0,0,267,0
2012,43,Schoharie,Urban,Unknown,0,0,,0,0,,0,0,,0,0,,0,0,,0,2,0,0,0,0,0,2,0,0,2,0
2012,11,Cortland,Rural,Unknown,0,1,0,0,0,0,0,0,0,0,0,0,0,1,0,0,101,0,0,14,0,0,115,0,0,116,0
2013,50,Tompkins,Urban,Unknown,0,1,0,0,0,0,0,1,0,0,1,0,0,2,0,0,67,0,0,12,0,0,79,0,0,81,0
2012,61,Queens,Urban,Unknown,0,882,0,1,259,3.861,0,187,0,1,446,2.242,1,1328,0.753,0,2927,0,0,301,0,0,3228,0,1,4556,0.219
2011,4,Cattaraugus,Rural,Unknown,0,2,0,0,0,0,0,0,0,0,0,0,0,2,0,0,42,0,0,3,0,0,45,0,0,47,0
2015,24,Livingston,Urban,Unknown,0,3,0,0,0,0,0,0,0,0,0,0,0,3,0,0,5,0,0,0,0,0,5,0,0,8,0
2010,27,Montgomery,Rural,Unknown,0,529,0,0,2,0,0,17,0,0,19,0,0,548,0,0,395,0,0,0,0,0,395,0,0,943,0
2014,48,Sullivan,Rural,Unknown,0,5,0,0,0,0,0,0,0,0,0,0,0,5,0,0,6,0,0,240,0,0,246,0,0,251,0
2015,18,Genesee,Rural,Unknown,0,2,0,0,0,0,0,0,0,0,0,0,0,2,0,0,5,0,0,4,0,0,9,0,0,11,0
2011,35,Oswego,Urban,Unknown,0,2,0,0,0,0,0,0,0,0,0,0,0,2,0,0,3,0,0,1,0,0,4,0,0,6,0
2011,,Statewide Total,State,Unknown,20,31063,0.644,11,2297,4.789,1,1764,0.567,12,4061,2.955,32,35124,0.911,0,68306,0,0,8565,0,0,76871,0,32,111995,0.286
2015,3,Broome,Urban,Unknown,0,6,0,0,4,0,0,5,0,0,9,0,0,15,0,0,4,0,0,10,0,0,14,0,0,29,0
2010,35,Oswego,Urban,Unknown,0,442,0,0,33,0,0,165,0,0,198,0,0,640,0,0,1248,0,0,7,0,0,1255,0,0,1895,0
2010,49,Tioga,Urban,Unknown,1,1150,0.87,0,117,0,0,108,0,0,225,0,1,1375,0.727,0,615,0,0,0,0,0,615,0,1,1990,0.503
2015,5,Cayuga,Rural,Unknown,0,5,0,0,8,0,0,1,0,0,9,0,0,14,0,0,5,0,0,1,0,0,6,0,0,20,0
2011,19,Greene,Rural,Unknown,0,5,0,0,0,0,1,2,500,1,2,500,1,7,142.857,0,2,0,0,0,0,0,2,0,1,9,111.111
2014,24,Livingston,Urban,Unknown,0,1,0,0,0,0,0,0,0,0,0,0,0,1,0,0,35,0,0,0,0,0,35,0,0,36,0
2014,44,Schuyler,Rural,Unknown,0,5,0,0,1,0,0,1,0,0,2,0,0,7,0,0,7,0,0,45,0,0,52,0,0,59,0
2013,38,Rensselaer,Urban,Unknown,0,0,0,0,0,0,0,2,0,0,2,0,0,2,0,0,1,0,0,0,0,0,1,0,0,3,0
2011,88,Other than New York State,Urban,Unknown,0,302,0,0,60,0,0,111,0,0,171,0,0,473,0,0,1087,0,0,82,0,0,1169,0,0,1642,0
2013,62,Richmond (Staten Island),Urban,Unknown,0,45,0,0,6,0,0,29,0,0,35,0,0,80,0,0,45,0,0,42,0,0,87,0,0,167,0
2014,31,Onondaga,Urban,Unknown,0,32,0,0,2,0,0,11,0,0,13,0,0,45,0,0,709,0,0,10,0,0,719,0,0,764,0
2012,18,Genesee,Rural,Unknown,0,0,,0,0,,0,0,,0,0,,0,0,,0,288,0,0,4,0,0,292,0,0,292,0
2010,19,Greene,Rural,Unknown,0,451,0,0,0,0,0,7,0,0,7,0,0,458,0,0,380,0,0,0,0,0,380,0,0,838,0
2011,18,Genesee,Rural,Unknown,0,4,0,0,0,0,0,0,0,0,0,0,0,4,0,0,325,0,0,3,0,0,328,0,0,332,0
2013,32,Ontario,Urban,Unknown,0,2,0,0,0,0,0,0,0,0,0,0,0,2,0,0,511,0,0,0,0,0,511,0,0,513,0
2015,44,Schuyler,Rural,Unknown,0,5,0,0,1,0,0,2,0,0,3,0,0,8,0,0,6,0,0,54,0,0,60,0,0,68,0
2015,12,Delaware,Rural,Unknown,0,203,0,0,1,0,0,0,0,0,1,0,0,204,0,0,3,0,0,704,0,0,707,0,0,911,0
2015,19,Greene,Rural,Unknown,0,5,0,0,1,0,0,1,0,0,2,0,0,7,0,0,0,0,0,1,0,0,1,0,0,8,0
2013,37,Putnam,Urban,Unknown,0,8,0,0,0,0,0,3,0,0,3,0,0,11,0,0,115,0,0,9,0,0,124,0,0,135,0
2011,48,Sullivan,Rural,Unknown,0,46,0,0,2,0,0,7,0,0,9,0,0,55,0,0,235,0,0,379,0,0,614,0,0,669,0
2014,23,Lewis,Rural,Unknown,0,36,0,0,4,0,0,41,0,0,45,0,0,81,0,0,96,0,0,45,0,0,141,0,0,222,0
2014,13,Dutchess,Urban,Unknown,0,11,0,0,1,0,0,9,0,0,10,0,0,21,0,0,29,0,0,9,0,0,38,0,0,59,0
2010,11,Cortland,Rural,Unknown,2,255,7.843,0,24,0,0,44,0,0,68,0,2,323,6.192,0,873,0,0,0,0,0,873,0,2,1196,1.672
2014,17,Fulton,Rural,Unknown,0,8,0,0,1,0,0,1,0,0,2,0,0,10,0,0,8,0,0,3,0,0,11,0,0,21,0
2011,24,Livingston,Urban,Unknown,0,5,0,0,0,0,0,0,0,0,0,0,0,5,0,0,680,0,0,1,0,0,681,0,0,686,0
2013,39,Rockland,Urban,Unknown,0,8,0,0,0,0,0,4,0,0,4,0,0,12,0,0,15,0,0,7,0,0,22,0,0,34,0
2013,56,Wyoming,Rural,Unknown,0,0,,0,0,,0,0,,0,0,,0,0,,0,63,0,0,0,0,0,63,0,0,63,0
2010,31,Onondaga,Urban,Unknown,4,7818,0.512,3,1424,2.107,0,1330,0,3,2754,1.089,7,10572,0.662,0,4546,0,0,14,0,0,4560,0,7,15132,0.463
2010,6,Chautauqua,Rural,Unknown,0,2119,0,0,25,0,0,18,0,0,43,0,0,2162,0,0,636,0,0,0,0,0,636,0,0,2798,0
2014,53,Washington,Urban,Unknown,0,3,0,0,1,0,0,1,0,0,2,0,0,5,0,0,2,0,0,1,0,0,3,0,0,8,0
2013,22,Jefferson,Urban,Unknown,0,1,0,0,0,0,0,0,0,0,0,0,0,1,0,0,273,0,0,15,0,0,288,0,0,289,0
2014,62,Richmond (Staten Island),Urban,Unknown,0,61,0,0,3,0,0,26,0,0,29,0,0,90,0,0,75,0,0,38,0,0,113,0,0,203,0
2015,57,Yates,Urban,Unknown,0,1,0,0,0,0,0,1,0,0,1,0,0,2,0,0,0,0,0,8,0,0,8,0,0,10,0
2012,45,Seneca,Rural,Unknown,0,0,,0,0,,0,0,,0,0,,0,0,,0,35,0,0,2,0,0,37,0,0,37,0
2011,31,Onondaga,Urban,Unknown,0,3,0,0,0,0,0,0,0,0,0,0,0,3,0,0,20,0,0,3,0,0,23,0,0,26,0
2010,14,Erie,Urban,Unknown,0,6339,0,1,105,9.524,0,21,0,1,126,7.937,1,6465,0.155,0,19773,0,0,0,0,0,19773,0,1,26238,0.038
2013,45,Seneca,Rural,Unknown,0,0,,0,0,,0,0,,0,0,,0,0,,0,41,0,0,15,0,0,56,0,0,56,0
2014,16,Franklin,Rural,Unknown,0,18,0,0,36,0,0,23,0,0,59,0,0,77,0,0,35,0,0,110,0,0,145,0,0,222,0
2015,58,Bronx,Urban,Unknown,0,286,0,0,8,0,0,71,0,0,79,0,0,365,0,0,298,0,0,167,0,0,465,0,0,830,0
2012,14,Erie,Urban,Unknown,0,0,0,0,0,0,0,1,0,0,1,0,0,1,0,0,7169,0,0,98,0,0,7267,0,0,7268,0
2012,57,Yates,Urban,Unknown,0,0,,0,0,,0,0,,0,0,,0,0,,0,60,0,0,0,0,0,60,0,0,60,0
2010,3,Broome,Urban,Unknown,3,8277,0.362,2,1360,1.471,0,1001,0,2,2361,0.847,5,10638,0.47,0,3115,0,0,0,0,0,3115,0,5,13753,0.364
2015,60,New York (Manhattan),Urban,Unknown,0,466,0,0,94,0,1,233,4.292,1,327,3.058,1,793,1.261,0,1317,0,0,434,0,0,1751,0,1,2544,0.393
2011,5,Cayuga,Rural,Unknown,0,1,0,0,0,0,0,0,0,0,0,0,0,1,0,0,13,0,0,1,0,0,14,0,0,15,0
2015,39,Rockland,Urban,Unknown,0,7,0,0,1,0,0,3,0,0,4,0,0,11,0,0,17,0,0,15,0,0,32,0,0,43,0
2014,60,New York (Manhattan),Urban,Unknown,0,928,0,0,119,0,0,191,0,0,310,0,0,1238,0,0,1320,0,0,733,0,0,2053,0,0,3291,0
2012,5,Cayuga,Rural,Unknown,0,1,0,0,0,0,0,1,0,0,1,0,0,2,0,0,453,0,0,43,0,0,496,0,0,498,0
2011,32,Ontario,Urban,Unknown,0,7,0,0,0,0,0,0,0,0,0,0,0,7,0,0,719,0,0,1,0,0,720,0,0,727,0
2010,7,Chemung,Urban,Unknown,3,10724,0.28,0,48,0,0,12,0,0,60,0,3,10784,0.278,0,1811,0,0,0,0,0,1811,0,3,12595,0.238
2014,57,Yates,Urban,Unknown,0,0,0,0,1,0,0,0,0,0,1,0,0,1,0,0,8,0,0,7,0,0,15,0,0,16,0
2014,40,St. Lawrence,Rural,Unknown,0,4,0,0,9,0,0,15,0,0,24,0,0,28,0,0,16,0,0,15,0,0,31,0,0,59,0
2013,18,Genesee,Rural,Unknown,0,1,0,0,0,0,0,0,0,0,0,0,0,1,0,0,303,0,0,3,0,0,306,0,0,307,0
2010,46,Steuben,Rural,Unknown,4,8918,0.449,0,389,0,0,178,0,0,567,0,4,9485,0.422,0,2676,0,0,0,0,0,2676,0,4,12161,0.329
2015,28,Nassau,Urban,Unknown,0,97,0,0,15,0,0,19,0,0,34,0,0,131,0,0,121,0,0,69,0,0,190,0,0,321,0
2014,29,Niagara,Urban,Unknown,0,3,0,0,0,0,0,0,0,0,0,0,0,3,0,0,170,0,0,19,0,0,189,0,0,192,0
2013,54,Wayne,Urban,Unknown,0,0,,0,0,,0,0,,0,0,,0,0,,0,846,0,0,6,0,0,852,0,0,852,0
2014,35,Oswego,Urban,Unknown,0,19,0,0,3,0,0,7,0,0,10,0,0,29,0,0,275,0,0,10,0,0,285,0,0,314,0
2013,42,Schenectady,Urban,Unknown,0,2,0,0,0,0,0,1,0,0,1,0,0,3,0,0,1,0,0,0,0,0,1,0,0,4,0
2010,61,Queens,Urban,Unknown,14,95498,0.147,17,14050,1.21,0,9196,0,17,23246,0.731,31,118744,0.261,0,25683,0,0,0,0,0,25683,0,31,144427,0.215
2010,5,Cayuga,Rural,Unknown,1,3325,0.301,5,873,5.727,0,604,0,5,1477,3.385,6,4802,1.249,0,1223,0,0,0,0,0,1223,0,6,6025,0.996
2012,23,Lewis,Rural,Unknown,0,0,,0,0,,0,0,,0,0,,0,0,,0,51,0,0,1,0,0,52,0,0,52,0
2013,46,Steuben,Rural,Unknown,0,9,0,0,2,0,0,1,0,0,3,0,0,12,0,0,93,0,0,121,0,0,214,0,0,226,0
2013,11,Cortland,Rural,Unknown,0,0,,0,0,,0,0,,0,0,,0,0,,0,154,0,0,19,0,0,173,0,0,173,0
2013,15,Essex,Rural,Unknown,0,6,0,0,1,0,0,0,0,0,1,0,0,7,0,0,4,0,0,11,0,0,15,0,0,22,0
2015,35,Oswego,Urban,Unknown,0,15,0,0,14,0,0,6,0,0,20,0,0,35,0,0,26,0,0,9,0,0,35,0,0,70,0
2012,26,Monroe,Urban,Unknown,0,5,0,0,0,0,0,0,0,0,0,0,0,5,0,0,14242,0,0,12,0,0,14254,0,0,14259,0
2014,7,Chemung,Urban,Unknown,0,198,0,0,35,0,0,13,0,0,48,0,0,246,0,0,30,0,0,793,0,0,823,0,0,1069,0
2013,51,Ulster,Urban,Unknown,0,4,0,0,0,0,0,0,0,0,0,0,0,4,0,0,33,0,0,0,0,0,33,0,0,37,0
2014,33,Orange,Urban,Unknown,0,29,0,0,2,0,0,7,0,0,9,0,0,38,0,0,72,0,0,6,0,0,78,0,0,116,0
2010,33,Orange,Urban,Unknown,8,22269,0.359,4,532,7.519,0,625,0,4,1157,3.457,12,23426,0.512,0,6702,0,0,0,0,0,6702,0,12,30128,0.398
2014,37,Putnam,Urban,Unknown,0,13,0,0,1,0,0,3,0,0,4,0,0,17,0,0,17,0,0,6,0,0,23,0,0,40,0
2013,60,New York (Manhattan),Urban,Unknown,0,855,0,0,124,0,0,188,0,0,312,0,0,1167,0,0,1241,0,0,726,0,0,1967,0,0,3134,0
2013,58,Bronx,Urban,Unknown,0,486,0,0,43,0,0,76,0,0,119,0,0,605,0,0,764,0,0,164,0,0,928,0,0,1533,0
2012,2,Allegany,Rural,Unknown,0,0,,0,0,,0,0,,0,0,,0,0,,0,18,0,0,0,0,0,18,0,0,18,0
2011,9,Clinton,Rural,Unknown,0,0,,0,0,,0,0,,0,0,,0,0,,0,2,0,0,0,0,0,2,0,0,2,0
2014,52,Warren,Urban,Unknown,0,4,0,0,1,0,0,1,0,0,2,0,0,6,0,0,4,0,0,0,0,0,4,0,0,10,0
2010,58,Bronx,Urban,Unknown,10,37861,0.264,13,7204,1.805,14,10368,1.35,27,17572,1.537,37,55433,0.667,0,26135,0,0,0,0,0,26135,0,37,81568,0.454
2015,21,Herkimer,Urban,Unknown,2,1111,1.8,1,351,2.849,0,166,0,1,517,1.934,3,1628,1.843,0,521,0,0,523,0,0,1044,0,3,2672,1.123
2015,52,Warren,Urban,Unknown,0,14,0,0,1,0,0,0,0,0,1,0,0,15,0,0,18,0,0,11,0,0,29,0,0,44,0
2013,41,Saratoga,Urban,Unknown,0,0,,0,0,,0,0,,0,0,,0,0,,0,4,0,0,0,0,0,4,0,0,4,0
2013,9,Clinton,Rural,Unknown,0,56,0,0,32,0,0,8,0,0,40,0,0,96,0,0,26,0,0,62,0,0,88,0,0,184,0
2013,10,Columbia,Rural,Unknown,0,1,0,0,0,0,0,0,0,0,0,0,0,1,0,0,2,0,0,0,0,0,2,0,0,3,0
2010,40,St. Lawrence,Rural,Unknown,0,9381,0,2,140,14.286,0,99,0,2,239,8.368,2,9620,0.208,0,2454,0,0,0,0,0,2454,0,2,12074,0.166
2010,20,Hamilton,Rural,Unknown,0,119,0,0,2,0,0,1,0,0,3,0,0,122,0,0,135,0,0,0,0,0,135,0,0,257,0
2013,26,Monroe,Urban,Unknown,0,3,0,0,0,0,0,0,0,0,0,0,0,3,0,0,10230,0,0,16,0,0,10246,0,0,10249,0
2013,49,Tioga,Urban,Unknown,0,1,0,0,0,0,0,2,0,0,2,0,0,3,0,0,12,0,0,16,0,0,28,0,0,31,0
2011,22,Jefferson,Urban,Unknown,0,0,0,0,1,0,0,0,0,0,1,0,0,1,0,0,10,0,0,0,0,0,10,0,0,11,0
2012,32,Ontario,Urban,Unknown,0,0,,0,0,,0,0,,0,0,,0,0,,0,657,0,0,2,0,0,659,0,0,659,0
2013,48,Sullivan,Rural,Unknown,0,8,0,0,0,0,0,1,0,0,1,0,0,9,0,0,10,0,0,191,0,0,201,0,0,210,0
2011,51,Ulster,Urban,Unknown,1,1061,0.943,0,44,0,0,40,0,0,84,0,1,1145,0.873,0,130,0,0,201,0,0,331,0,1,1476,0.678
2010,34,Orleans,Urban,Unknown,0,1217,0,1,325,3.077,0,130,0,1,455,2.198,1,1672,0.598,0,667,0,0,0,0,0,667,0,1,2339,0.428
2014,8,Chenango,Rural,Unknown,0,25,0,0,1,0,0,2,0,0,3,0,0,28,0,0,15,0,0,16,0,0,31,0,0,59,0
2015,6,Chautauqua,Rural,Unknown,0,1,0,0,0,0,0,0,0,0,0,0,0,1,0,0,2,0,0,1,0,0,3,0,0,4,0
2013,12,Delaware,Rural,Unknown,1,702,1.425,0,13,0,0,4,0,0,17,0,1,719,1.391,0,30,0,0,1189,0,0,1219,0,1,1938,0.516
2013,47,Suffolk,Urban,Unknown,0,694,0,2,451,4.435,0,193,0,2,644,3.106,2,1338,1.495,0,1209,0,0,263,0,0,1472,0,2,2810,0.712
2014,88,Other than New York State,Urban,Unknown,0,683,0,0,79,0,1,121,8.264,1,200,5,1,883,1.133,0,516,0,0,597,0,0,1113,0,1,1996,0.501
2012,4,Cattaraugus,Rural,Unknown,0,0,,0,0,,0,0,,0,0,,0,0,,0,32,0,0,0,0,0,32,0,0,32,0
2010,59,Kings (Brooklyn),Urban,Unknown,18,82902,0.217,17,15687,1.084,19,29275,0.649,36,44962,0.801,54,127864,0.422,0,26264,0,0,0,0,0,26264,0,54,154128,0.35
2011,60,New York (Manhattan),Urban,Unknown,0,637,0,1,82,12.195,0,143,0,1,225,4.444,1,862,1.16,0,4954,0,0,288,0,0,5242,0,1,6104,0.164
2012,40,St. Lawrence,Rural,Unknown,0,0,,0,0,,0,0,,0,0,,0,0,,0,53,0,0,4,0,0,57,0,0,57,0
2010,51,Ulster,Urban,Unknown,1,7188,0.139,0,96,0,0,108,0,0,204,0,1,7392,0.135,2,2144,0.933,0,0,0,2,2144,0.933,3,9536,0.315
2015,,Statewide Total,State,Unknown,16,18311,0.874,8,2837,2.82,14,3195,4.382,22,6032,3.647,38,24343,1.561,0,8965,0,0,12519,0,0,21484,0,38,45827,0.829
2012,22,Jefferson,Urban,Unknown,0,0,,0,0,,0,0,,0,0,,0,0,,0,258,0,0,13,0,0,271,0,0,271,0
2014,25,Madison,Urban,Unknown,1,104,9.615,0,15,0,0,40,0,0,55,0,1,159,6.289,0,120,0,0,78,0,0,198,0,1,357,2.801
2014,41,Saratoga,Urban,Unknown,0,18,0,0,1,0,0,2,0,0,3,0,0,21,0,0,7,0,0,19,0,0,26,0,0,47,0
2015,45,Seneca,Rural,Unknown,0,1,0,0,1,0,0,1,0,0,2,0,0,3,0,0,1,0,0,12,0,0,13,0,0,16,0
2010,23,Lewis,Rural,Unknown,0,816,0,0,90,0,0,58,0,0,148,0,0,964,0,0,438,0,0,0,0,0,438,0,0,1402,0
2013,29,Niagara,Urban,Unknown,0,0,,0,0,,0,0,,0,0,,0,0,,0,1351,0,0,15,0,0,1366,0,0,1366,0
2010,53,Washington,Urban,Unknown,2,4536,0.441,0,1,0,0,1,0,0,2,0,2,4538,0.441,0,2642,0,0,0,0,0,2642,0,2,7180,0.279
2011,52,Warren,Urban,Unknown,0,2,0,0,1,0,0,0,0,0,1,0,0,3,0,0,2,0,0,0,0,0,2,0,0,5,0
2010,48,Sullivan,Rural,Unknown,0,2361,0,4,1065,3.756,0,644,0,4,1709,2.341,4,4070,0.983,0,1749,0,0,0,0,0,1749,0,4,5819,0.687
2012,50,Tompkins,Urban,Unknown,0,0,0,0,0,0,0,1,0,0,1,0,0,1,0,0,41,0,0,6,0,0,47,0,0,48,0
2014,18,Genesee,Rural,Unknown,0,2,0,0,0,0,0,0,0,0,0,0,0,2,0,0,25,0,0,5,0,0,30,0,0,32,0
2011,43,Schoharie,Urban,Unknown,0,0,0,0,1,0,0,0,0,0,1,0,0,1,0,0,0,0,0,35,0,0,35,0,0,36,0
2013,27,Montgomery,Rural,Unknown,0,0,,0,0,,0,0,,0,0,,0,0,,0,5,0,0,0,0,0,5,0,0,5,0
2013,40,St. Lawrence,Rural,Unknown,0,0,0,0,0,0,0,1,0,0,1,0,0,1,0,0,70,0,0,18,0,0,88,0,0,89,0
2010,54,Wayne,Urban,Unknown,0,483,0,0,9,0,0,22,0,0,31,0,0,514,0,0,1840,0,0,0,0,0,1840,0,0,2354,0
2012,58,Bronx,Urban,Unknown,0,360,0,0,41,0,0,81,0,0,122,0,0,482,0,0,810,0,0,132,0,0,942,0,0,1424,0
2012,54,Wayne,Urban,Unknown,0,0,0,0,1,0,0,0,0,0,1,0,0,1,0,0,1226,0,0,4,0,0,1230,0,0,1231,0
2014,,Statewide Total,State,Unknown,13,18742,0.694,4,2409,1.66,16,4109,3.894,20,6518,3.068,33,25260,1.306,0,18967,0,0,11089,0,0,30056,0,33,55316,0.597
2015,54,Wayne,Urban,Unknown,0,3,0,0,0,0,0,1,0,0,1,0,0,4,0,0,11,0,0,0,0,0,11,0,0,15,0
2013,17,Fulton,Rural,Unknown,0,0,,0,0,,0,0,,0,0,,0,0,,0,2,0,0,0,0,0,2,0,0,2,0
2011,15,Essex,Rural,Unknown,0,0,,0,0,,0,0,,0,0,,0,0,,0,1,0,0,1,0,0,2,0,0,2,0
2014,4,Cattaraugus,Rural,Unknown,0,0,,0,0,,0,0,,0,0,,0,0,,0,7,0,0,1,0,0,8,0,0,8,0
2013,34,Orleans,Urban,Unknown,0,0,,0,0,,0,0,,0,0,,0,0,,0,175,0,0,0,0,0,175,0,0,175,0
2010,32,Ontario,Urban,Unknown,4,5214,0.767,0,6,0,0,10,0,0,16,0,4,5230,0.765,0,3966,0,0,0,0,0,3966,0,4,9196,0.435
2015,61,Queens,Urban,Unknown,0,564,0,1,22,45.455,0,114,0,1,136,7.353,1,700,1.429,0,448,0,0,273,0,0,721,0,1,1421,0.704
2015,51,Ulster,Urban,Unknown,0,17,0,0,3,0,0,1,0,0,4,0,0,21,0,0,3,0,0,0,0,0,3,0,0,24,0
2013,2,Allegany,Rural,Unknown,0,1,0,0,0,0,0,2,0,0,2,0,0,3,0,0,8,0,0,1,0,0,9,0,0,12,0
2011,10,Columbia,Rural,Unknown,0,3,0,0,0,0,0,1,0,0,1,0,0,4,0,0,11,0,0,0,0,0,11,0,0,15,0
2013,19,Greene,Rural,Unknown,0,0,0,0,0,0,0,1,0,0,1,0,0,1,0,0,0,,0,0,,0,0,,0,1,0
2012,7,Chemung,Urban,Unknown,0,0,,0,0,,0,0,,0,0,,0,0,,0,32,0,0,0,0,0,32,0,0,32,0
2013,13,Dutchess,Urban,Unknown,0,4,0,0,1,0,0,13,0,0,14,0,0,18,0,0,212,0,0,2,0,0,214,0,0,232,0
2014,27,Montgomery,Rural,Unknown,0,14,0,0,0,0,0,6,0,0,6,0,0,20,0,0,12,0,0,8,0,0,20,0,0,40,0
2015,42,Schenectady,Urban,Unknown,1,13,76.923,0,4,0,0,1,0,0,5,0,1,18,55.556,0,2,0,0,8,0,0,10,0,1,28,35.714
2011,20,Hamilton,Rural,Unknown,0,0,,0,0,,0,0,,0,0,,0,0,,0,1,0,0,0,0,0,1,0,0,1,0
2012,62,Richmond (Staten Island),Urban,Unknown,1,658,1.52,0,57,0,0,25,0,0,82,0,1,740,1.351,0,110,0,0,32,0,0,142,0,1,882,1.134
2012,3,Broome,Urban,Unknown,0,11,0,0,2,0,0,1,0,0,3,0,0,14,0,0,28,0,0,5,0,0,33,0,0,47,0
2013,55,Westchester,Urban,Unknown,0,153,0,0,11,0,0,33,0,0,44,0,0,197,0,0,415,0,0,566,0,0,981,0,0,1178,0
2014,58,Bronx,Urban,Unknown,0,568,0,0,29,0,0,97,0,0,126,0,0,694,0,0,571,0,0,265,0,0,836,0,0,1530,0
2014,61,Queens,Urban,Unknown,0,895,0,0,207,0,0,250,0,0,457,0,0,1352,0,0,786,0,0,323,0,0,1109,0,0,2461,0
2013,21,Herkimer,Urban,Unknown,0,1,0,0,0,0,0,0,0,0,0,0,0,1,0,0,31,0,0,1,0,0,32,0,0,33,0
2011,56,Wyoming,Rural,Unknown,0,0,,0,0,,0,0,,0,0,,0,0,,0,78,0,0,4,0,0,82,0,0,82,0
2010,18,Genesee,Rural,Unknown,0,279,0,0,16,0,0,17,0,0,33,0,0,312,0,0,534,0,0,0,0,0,534,0,0,846,0
2011,45,Seneca,Rural,Unknown,0,0,,0,0,,0,0,,0,0,,0,0,,0,34,0,0,0,0,0,34,0,0,34,0
2012,28,Nassau,Urban,Unknown,0,85,0,1,260,3.846,0,218,0,1,478,2.092,1,563,1.776,0,3943,0,0,45,0,0,3988,0,1,4551,0.22
2011,25,Madison,Urban,Unknown,0,6,0,0,0,0,0,0,0,0,0,0,0,6,0,0,2,0,0,13,0,0,15,0,0,21,0
2014,39,Rockland,Urban,Unknown,0,8,0,0,2,0,0,5,0,0,7,0,0,15,0,0,22,0,0,7,0,0,29,0,0,44,0
2015,16,Franklin,Rural,Unknown,0,17,0,0,20,0,0,17,0,0,37,0,0,54,0,0,29,0,0,121,0,0,150,0,0,204,0
2011,99,Unknown,Urban,Unknown,2,3069,0.652,0,51,0,0,31,0,0,82,0,2,3151,0.635,0,406,0,0,87,0,0,493,0,2,3644,0.549
2014,34,Orleans,Urban,Unknown,0,0,,0,0,,0,0,,0,0,,0,0,,0,26,0,0,0,0,0,26,0,0,26,0
2010,,Statewide Total,State,Unknown,220,611550,0.36,117,66216,1.767,37,73836,0.501,154,140052,1.1,374,751602,0.498,3,324820,0.009,0,23,0,3,324843,0.009,377,1076445,0.35
2015,11,Cortland,Rural,Unknown,0,6,0,0,1,0,0,0,0,0,1,0,0,7,0,0,2,0,0,0,0,0,2,0,0,9,0
2015,29,Niagara,Urban,Unknown,0,83,0,0,0,0,0,1,0,0,1,0,0,84,0,0,25,0,0,31,0,0,56,0,0,140,0
2015,8,Chenango,Rural,Unknown,0,29,0,0,12,0,0,3,0,0,15,0,0,44,0,0,12,0,0,44,0,0,56,0,0,100,0
2015,7,Chemung,Urban,Unknown,0,208,0,0,35,0,0,21,0,0,56,0,0,264,0,0,25,0,0,940,0,0,965,0,0,1229,0
2015,30,Oneida,Urban,Unknown,7,6499,1.077,2,1475,1.356,0,665,0,2,2140,0.935,9,8639,1.042,0,2475,0,0,2514,0,0,4989,0,9,13628,0.66
2010,57,Yates,Urban,Unknown,0,481,0,1,7,142.857,0,2,0,1,9,111.111,1,490,2.041,0,513,0,0,0,0,0,513,0,1,1003,0.997
2015,25,Madison,Urban,Unknown,0,119,0,1,61,16.393,0,38,0,1,99,10.101,1,218,4.587,0,91,0,0,107,0,0,198,0,1,416,2.404
2014,3,Broome,Urban,Unknown,0,10,0,0,3,0,0,2,0,0,5,0,0,15,0,0,5,0,0,3,0,0,8,0,0,23,0
2014,46,Steuben,Rural,Unknown,0,7,0,0,4,0,0,10,0,0,14,0,0,21,0,0,19,0,0,225,0,0,244,0,0,265,0
2012,27,Montgomery,Rural,Unknown,0,0,,0,0,,0,0,,0,0,,0,0,,0,6,0,0,0,0,0,6,0,0,6,0
2013,24,Livingston,Urban,Unknown,0,0,,0,0,,0,0,,0,0,,0,0,,0,383,0,0,1,0,0,384,0,0,384,0
2014,36,Otsego,Rural,Unknown,0,25,0,0,3,0,0,5,0,0,8,0,0,33,0,0,15,0,0,20,0,0,35,0,0,68,0
2011,17,Fulton,Rural,Unknown,0,0,,0,0,,0,0,,0,0,,0,0,,0,0,0,0,2,0,0,2,0,0,2,0
2014,11,Cortland,Rural,Unknown,0,2,0,0,1,0,0,0,0,0,1,0,0,3,0,0,11,0,0,1,0,0,12,0,0,15,0
2011,57,Yates,Urban,Unknown,0,1,0,0,1,0,0,0,0,0,1,0,0,2,0,0,51,0,0,0,0,0,51,0,0,53,0
2015,48,Sullivan,Rural,Unknown,0,12,0,0,1,0,0,0,0,0,1,0,0,13,0,0,7,0,0,165,0,0,172,0,0,185,0
2014,21,Herkimer,Urban,Unknown,1,887,1.127,0,70,0,1,243,4.115,1,313,3.195,2,1200,1.667,0,414,0,0,353,0,0,767,0,2,1967,1.017
2014,49,Tioga,Urban,Unknown,0,2,0,0,0,0,0,1,0,0,1,0,0,3,0,0,0,0,0,13,0,0,13,0,0,16,0
2015,22,Jefferson,Urban,Unknown,0,13,0,0,6,0,0,3,0,0,9,0,0,22,0,0,30,0,0,9,0,0,39,0,0,61,0
2012,16,Franklin,Rural,Unknown,0,0,0,0,0,0,0,1,0,0,1,0,0,1,0,0,0,,0,0,,0,0,,0,1,0
2014,43,Schoharie,Urban,Unknown,0,0,0,0,0,0,0,1,0,0,1,0,0,1,0,0,2,0,0,1,0,0,3,0,0,4,0
2013,59,Kings (Brooklyn),Urban,Unknown,0,8015,0,11,845,13.018,7,974,7.187,18,1819,9.896,18,9834,1.83,0,679,0,0,2075,0,0,2754,0,18,12588,1.43
2015,62,Richmond (Staten Island),Urban,Unknown,1,50,20,0,1,0,0,11,0,0,12,0,1,62,16.129,0,50,0,0,15,0,0,65,0,1,127,7.874
2012,21,Herkimer,Urban,Unknown,0,0,,0,0,,0,0,,0,0,,0,0,,0,34,0,0,3,0,0,37,0,0,37,0
2012,10,Columbia,Rural,Unknown,0,2,0,0,0,0,0,2,0,0,2,0,0,4,0,0,10,0,0,1,0,0,11,0,0,15,0
2014,20,Hamilton,Rural,Unknown,0,14,0,0,2,0,0,8,0,0,10,0,0,24,0,0,8,0,0,3,0,0,11,0,0,35,0
2012,19,Greene,Rural,Unknown,0,0,,0,0,,0,0,,0,0,,0,0,,0,2,0,0,0,0,0,2,0,0,2,0
2015,33,Orange,Urban,Unknown,0,13,0,0,0,0,0,8,0,0,8,0,0,21,0,0,64,0,0,8,0,0,72,0,0,93,0
2011,29,Niagara,Urban,Unknown,0,0,,0,0,,0,0,,0,0,,0,0,,0,1470,0,0,58,0,0,1528,0,0,1528,0
2011,44,Schuyler,Rural,Unknown,0,0,,0,0,,0,0,,0,0,,0,0,,0,2,0,0,0,0,0,2,0,0,2,0
2015,53,Washington,Urban,Unknown,0,15,0,0,3,0,0,5,0,0,8,0,0,23,0,0,23,0,0,29,0,0,52,0,0,75,0
2015,2,Allegany,Rural,Unknown,0,2,0,0,0,0,0,2,0,0,2,0,0,4,0,0,0,0,0,1,0,0,1,0,0,5,0
2011,1,Albany,Urban,Unknown,0,12,0,0,1,0,0,4,0,0,5,0,0,17,0,0,2,0,0,17,0,0,19,0,0,36,0
2015,32,Ontario,Urban,Unknown,0,5,0,0,3,0,0,0,0,0,3,0,0,8,0,0,10,0,0,0,0,0,10,0,0,18,0
2012,51,Ulster,Urban,Unknown,0,1,0,0,0,0,0,1,0,0,1,0,0,2,0,0,18,0,0,1,0,0,19,0,0,21,0
2011,28,Nassau,Urban,Unknown,0,126,0,1,297,3.367,0,255,0,1,552,1.812,1,678,1.475,0,6739,0,0,129,0,0,6868,0,1,7546,0.133
2011,16,Franklin,Rural,Unknown,0,3,0,0,0,0,0,0,0,0,0,0,0,3,0,0,0,,0,0,,0,0,,0,3,0
2011,36,Otsego,Rural,Unknown,0,13,0,0,0,0,0,1,0,0,1,0,0,14,0,0,2,0,0,619,0,0,621,0,0,635,0
2011,38,Rensselaer,Urban,Unknown,0,3,0,0,0,0,0,1,0,0,1,0,0,4,0,0,2,0,0,0,0,0,2,0,0,6,0
2013,99,Unknown,Urban,Unknown,0,1134,0,0,71,0,1,46,21.739,1,117,8.547,1,1251,0.799,0,6918,0,0,62,0,0,6980,0,1,8231,0.121
2010,45,Seneca,Rural,Unknown,0,562,0,0,8,0,0,17,0,0,25,0,0,587,0,0,371,0,0,0,0,0,371,0,0,958,0
2015,55,Westchester,Urban,Unknown,0,58,0,0,7,0,0,22,0,0,29,0,0,87,0,0,172,0,0,585,0,0,757,0,0,844,0
2012,39,Rockland,Urban,Unknown,0,4,0,0,0,0,0,6,0,0,6,0,0,10,0,0,28,0,0,7,0,0,35,0,0,45,0
2011,2,Allegany,Rural,Unknown,0,1,0,0,0,0,0,0,0,0,0,0,0,1,0,0,15,0,0,0,0,0,15,0,0,16,0
2013,25,Madison,Urban,Unknown,0,1,0,0,0,0,0,0,0,0,0,0,0,1,0,0,525,0,0,79,0,0,604,0,0,605,0
2015,1,Albany,Urban,Unknown,0,17,0,0,3,0,0,2,0,0,5,0,0,22,0,0,2,0,0,4,0,0,6,0,0,28,0
2012,24,Livingston,Urban,Unknown,0,0,,0,0,,0,0,,0,0,,0,0,,0,594,0,0,1,0,0,595,0,0,595,0
2012,56,Wyoming,Rural,Unknown,0,0,,0,0,,0,0,,0,0,,0,0,,0,75,0,0,0,0,0,75,0,0,75,0
2010,16,Franklin,Rural,Unknown,1,2716,0.368,0,186,0,0,26,0,0,212,0,1,2928,0.342,0,629,0,0,0,0,0,629,0,1,3557,0.281
2014,26,Monroe,Urban,Unknown,0,18,0,0,0,0,0,3,0,0,3,0,0,21,0,0,973,0,0,4,0,0,977,0,0,998,0
2012,33,Orange,Urban,Unknown,0,10,0,0,2,0,0,8,0,0,10,0,0,20,0,0,178,0,0,18,0,0,196,0,0,216,0
2015,40,St. Lawrence,Rural,Unknown,0,5,0,0,6,0,0,15,0,0,21,0,0,26,0,0,11,0,0,32,0,0,43,0,0,69,0
2015,9,Clinton,Rural,Unknown,0,867,0,1,345,2.899,0,61,0,1,406,2.463,1,1273,0.786,0,428,0,0,2039,0,0,2467,0,1,3740,0.267
2015,15,Essex,Rural,Unknown,0,47,0,0,32,0,0,10,0,0,42,0,0,89,0,0,59,0,0,83,0,0,142,0,0,231,0
2011,61,Queens,Urban,Unknown,0,1221,0,1,250,4,0,218,0,1,468,2.137,1,1689,0.592,0,4982,0,0,270,0,0,5252,0,1,6941,0.144
2014,99,Unknown,Urban,Unknown,0,114,0,0,70,0,0,41,0,0,111,0,0,225,0,0,6539,0,0,123,0,0,6662,0,0,6887,0
2010,21,Herkimer,Urban,Unknown,0,550,0,0,11,0,0,15,0,0,26,0,0,576,0,0,585,0,0,0,0,0,585,0,0,1161,0
2012,46,Steuben,Rural,Unknown,0,2,0,0,0,0,0,0,0,0,0,0,0,2,0,0,89,0,0,1,0,0,90,0,0,92,0
2014,45,Seneca,Rural,Unknown,0,0,,0,0,,0,0,,0,0,,0,0,,0,9,0,0,30,0,0,39,0,0,39,0
2013,5,Cayuga,Rural,Unknown,0,1,0,0,0,0,0,0,0,0,0,0,0,1,0,0,604,0,0,57,0,0,661,0,0,662,0
2010,55,Westchester,Urban,Unknown,14,36282,0.386,1,457,2.188,0,1907,0,1,2364,0.423,15,38646,0.388,0,13342,0,0,0,0,0,13342,0,15,51988,0.289
2014,2,Allegany,Rural,Unknown,0,0,0,0,0,0,0,1,0,0,1,0,0,1,0,0,5,0,0,0,0,0,5,0,0,6,0
2012,42,Schenectady,Urban,Unknown,0,3,0,0,0,0,0,0,0,0,0,0,0,3,0,0,2,0,0,1,0,0,3,0,0,6,0
2010,25,Madison,Urban,Unknown,0,180,0,0,28,0,0,61,0,0,89,0,0,269,0,0,194,0,0,0,0,0,194,0,0,463,0
2011,62,Richmond (Staten Island),Urban,Unknown,0,1994,0,0,161,0,0,35,0,0,196,0,0,2190,0,0,343,0,0,67,0,0,410,0,0,2600,0
2010,24,Livingston,Urban,Unknown,0,4747,0,3,404,7.426,0,198,0,3,602,4.983,3,5349,0.561,0,1812,0,0,0,0,0,1812,0,3,7161,0.419
2013,35,Oswego,Urban,Unknown,0,1,0,0,0,0,0,0,0,0,0,0,0,1,0,0,1883,0,0,238,0,0,2121,0,0,2122,0
2010,9,Clinton,Rural,Unknown,0,173,0,0,5,0,0,4,0,0,9,0,0,182,0,0,672,0,0,0,0,0,672,0,0,854,0
2012,1,Albany,Urban,Unknown,0,3,0,0,0,0,0,2,0,0,2,0,0,5,0,0,4,0,0,1,0,0,5,0,0,10,0
2011,11,Cortland,Rural,Unknown,0,12,0,0,3,0,0,0,0,0,3,0,0,15,0,0,2,0,0,0,0,0,2,0,0,17,0
2013,1,Albany,Urban,Unknown,0,2,0,0,0,0,0,1,0,0,1,0,0,3,0,0,4,0,0,0,0,0,4,0,0,7,0
2010,26,Monroe,Urban,Unknown,0,4668,0,2,247,8.097,0,118,0,2,365,5.479,2,5033,0.397,0,18416,0,0,0,0,0,18416,0,2,23449,0.085
2012,30,Oneida,Urban,Unknown,0,1,0,0,0,0,0,0,0,0,0,0,0,1,0,0,325,0,0,19,0,0,344,0,0,345,0
2013,28,Nassau,Urban,Unknown,0,108,0,0,256,0,0,214,0,0,470,0,0,578,0,0,3407,0,0,53,0,0,3460,0,0,4038,0
2012,44,Schuyler,Rural,Unknown,0,0,,0,0,,0,0,,0,0,,0,0,,0,3,0,0,0,0,0,3,0,0,3,0
2014,32,Ontario,Urban,Unknown,0,0,0,0,0,0,0,1,0,0,1,0,0,1,0,0,69,0,0,1,0,0,70,0,0,71,0
2013,20,Hamilton,Rural,Unknown,0,0,,0,0,,0,0,,0,0,,0,0,,0,5,0,0,0,0,0,5,0,0,5,0
2012,35,Oswego,Urban,Unknown,0,0,,0,0,,0,0,,0,0,,0,0,,0,1348,0,0,139,0,0,1487,0,0,1487,0
2011,14,Erie,Urban,Unknown,0,1,0,0,0,0,0,0,0,0,0,0,0,1,0,0,7515,0,0,38,0,0,7553,0,0,7554,0
2013,4,Cattaraugus,Rural,Unknown,0,0,,0,0,,0,0,,0,0,,0,0,,0,28,0,0,1,0,0,29,0,0,29,0
2015,88,Other than New York State,Urban,Unknown,1,512,1.953,1,63,15.873,0,83,0,1,146,6.849,2,658,3.04,0,470,0,0,351,0,0,821,0,2,1479,1.352
2012,99,Unknown,Urban,Unknown,0,1739,0,0,22,0,0,7,0,0,29,0,0,1768,0,0,321,0,0,46,0,0,367,0,0,2135,0
2015,34,Orleans,Urban,Unknown,0,0,,0,0,,0,0,,0,0,,0,0,,0,36,0,0,0,0,0,36,0,0,36,0
2015,27,Montgomery,Rural,Unknown,0,14,0,0,5,0,0,4,0,0,9,0,0,23,0,0,14,0,0,10,0,0,24,0,0,47,0
2013,14,Erie,Urban,Unknown,0,4,0,0,1,0,0,2,0,0,3,0,0,7,0,0,6971,0,0,163,0,0,7134,0,0,7141,0
2011,34,Orleans,Urban,Unknown,0,6,0,0,0,0,0,0,0,0,0,0,0,6,0,0,171,0,0,1,0,0,172,0,0,178,0
2010,38,Rensselaer,Urban,Unknown,4,9081,0.44,0,87,0,0,23,0,0,110,0,4,9191,0.435,0,932,0,0,0,0,0,932,0,4,10123,0.395
2012,88,Other than New York State,Urban,Unknown,0,322,0,1,37,27.027,0,108,0,1,145,6.897,1,467,2.141,0,578,0,0,85,0,0,663,0,1,1130,0.885
2014,42,Schenectady,Urban,Unknown,0,10,0,0,0,0,0,1,0,0,1,0,0,11,0,0,2,0,0,4,0,0,6,0,0,17,0
2010,36,Otsego,Rural,Unknown,4,2884,1.387,0,11,0,0,18,0,0,29,0,4,2913,1.373,0,427,0,0,0,0,0,427,0,4,3340,1.198
2012,12,Delaware,Rural,Unknown,1,707,1.414,0,21,0,0,9,0,0,30,0,1,737,1.357,0,39,0,0,955,0,0,994,0,1,1731,0.578
2014,38,Rensselaer,Urban,Unknown,0,3,0,0,0,0,0,2,0,0,2,0,0,5,0,0,1,0,0,0,0,0,1,0,0,6,0
2010,42,Schenectady,Urban,Unknown,0,1788,0,0,28,0,0,26,0,0,54,0,0,1842,0,0,1959,0,0,0,0,0,1959,0,0,3801,0
